C:\Documents and Settings\Headspin\My Documents\Visual Studio Projects\ControlsDat\bin\Release\Data\ListInfo1.xml	C:\Documents and Settings\Headspin\My Documents\Visual Studio Projects\ControlsDat\bin\Release\Data\ListInfo2.xml
20pacgal	20pacgaa
bermudao	bermudaj
csclub	csclub1
decathlt	decathlo
dogosokj	
geebeeg	geebee
goldnpkc	pottnpkr
gp500	500gp
imago	imagoa
jokerpkr	potnpkra
kof95a	
megat3a	megat3ca
megat3b	megat3a
mvsc	mvscr1
pottnpkb	potnpkrb
pottnpkr	potnpkrc
raidndxa	raidndxt
samsho3a	
sbasketb	sbasketg
sbasketo	sbaskete
sbasketu	
tengai	tengaij
von	vonj
vonusa	von
	20pacgal
	3wonderh
	aerofgts
	armwaru1
	atarisy1
	babydad
	babypkr
	blckjack
	bsuerte
	bsuertea
	chanbara
	chocomk
	csclub
	cvsgd
	ddragob2
	decathlt
	demofist
	dogosokb
	dygolf
	eggventa
	firefox
	firefoxa
	fotns
	funlddlx
	gamecst2
	geebeeg
	ggxx
	ggxxrl
	goodluck
	gundmgd
	gundmxgd
	gwingb
	hotminda
	ikaria
	ikarinc
	ikaruga
	imago
	initd
	kof2003h
	kof95h
	madzoo
	magic10b
	magjoker
	marble5
	matrimbl
	megat3nj
	megat4sn
	megat5nj
	meltybld
	mk3p40
	mvsc
	para2dx
	pool10d
	potnpkrd
	potnpkre
	quizqgd
	ragtimea
	rapidrvr
	royale
	samsho3h
	sbasketb
	senko
	sgsafari
	shikgam2
	slashout
	sloco93
	sloco93a
	spacewin
	spkrbtl
	sprtjam
	ss2005
	tengai
	timcrs2b
	tnzsjn
	topskatu
	vathlete
	vf4
	videocba
	videodad
	videopkr
	vspsx
	vstrik3
	witchcda
	witchcdb
	witchcrd
	wsbbgd
005	005
10yard	10yard
10yardj	10yardj
11beat	11beat
1941	1941
1941j	1941j
1942	1942
1942a	1942a
1942b	1942b
1942w	1942w
1943	1943
1943j	1943j
1943kai	1943kai
1944	1944
1944j	1944j
1945kiii	1945kiii
19xx	19xx
19xxa	19xxa
19xxb	19xxb
19xxh	19xxh
19xxj	19xxj
19xxjr1	19xxjr1
1on1gov	1on1gov
2020bb	2020bb
2020bba	2020bba
2020bbh	2020bbh
280zzzap	280zzzap
2mindril	2mindril
39in1	39in1
3countb	3countb
3in1semi	3in1semi
3kokushi	3kokushi
3stooges	3stooges
3wonders	3wonders
3wonderu	3wonderu
40love	40love
47pie2	47pie2
47pie2o	47pie2o
4dwarrio	4dwarrio
4enraya	4enraya
4in1	4in1
4in1boot	4in1boot
4psimasy	4psimasy
600	600
64streej	64streej
64street	64street
720	720
720g	720g
720gr1	720gr1
720r1	720r1
720r2	720r2
720r3	720r3
7jigen	7jigen
7mezzo	7mezzo
7ordi	7ordi
7toitsu	7toitsu
800fath	800fath
88games	88games
8ball	8ball
8ball1	8ball1
8ballact	8ballact
8ballat2	8ballat2
8bpm	8bpm
99lstwar	99lstwar
99lstwra	99lstwra
99lstwrk	99lstwrk
9ballsh2	9ballsh2
9ballsh3	9ballsh3
9ballsht	9ballsht
a51mxr3k	a51mxr3k
a51site4	a51site4
aafb	aafb
aafbb	aafbb
aafbc	aafbc
aafbd2p	aafbd2p
abaseb	abaseb
abaseb2	abaseb2
abattle	abattle
abattle2	abattle2
abcop	abcop
abscam	abscam
abunai	abunai
aburner	aburner
aburner2	aburner2
ace	ace
aceattaa	aceattaa
aceattac	aceattac
acedrvrw	acedrvrw
acitya	acitya
acombat	acombat
acombato	acombato
acommand	acommand
acpsx	acpsx
acrobatm	acrobatm
actfanc1	actfanc1
actfancj	actfancj
actfancr	actfancr
actionhw	actionhw
ad2083	ad2083
aerfboo2	aerfboo2
aerfboot	aerfboot
aeroboto	aeroboto
aerofgt	aerofgt
aerofgtb	aerofgtb
aerofgtc	aerofgtc
afighter	afighter
afire	afire
agallet	agallet
agentx1	agentx1
agentx2	agentx2
agentx3	agentx3
agentx4	agentx4
agress	agress
agressb	agressb
ainferno	ainferno
airattca	airattca
airattck	airattck
airbusb	airbusb
airbustj	airbustj
airbustr	airbustr
airco22b	airco22b
aircombj	aircombj
aircombu	aircombu
airduel	airduel
airraid	airraid
airtrix	airtrix
airwolf	airwolf
airwolfa	airwolfa
ajax	ajax
ajaxj	ajaxj
akamaru	akamaru
akiss	akiss
akkanvdr	akkanvdr
aladbl	aladbl
alcon	alcon
aleck64	aleck64
alexkid1	alexkid1
alexkidd	alexkidd
alg_bios	alg_bios
alibaba	alibaba
alien3	alien3
alien3u	alien3u
alienar	alienar
alienaru	alienaru
alieninv	alieninv
aliens	aliens
aliens2	aliens2
aliens3	aliens3
aliensec	aliensec
aliensj	aliensj
aliensj2	aliensj2
aliensu	aliensu
aliensy1	aliensy1
aliensy2	aliensy2
aliensy3	aliensy3
aliensy5	aliensy5
aliensyn	aliensyn
aligator	aligator
aligatun	aligatun
alleymas	alleymas
alpha1v	alpha1v
alphaho	alphaho
alpham2	alpham2
alphamis	alphamis
alphaona	alphaona
alphaone	alphaone
alphaxz	alphaxz
alpine	alpine
alpinea	alpinea
alpinerc	alpinerc
alpinerd	alpinerd
alpinesa	alpinesa
alpinr2b	alpinr2b
altair	altair
altbeaj1	altbeaj1
altbeaj3	altbeaj3
altbeas2	altbeas2
altbeas4	altbeas4
altbeas5	altbeas5
altbeasj	altbeasj
altbeast	altbeast
amatelas	amatelas
amazon	amazon
ambush	ambush
ambusht	ambusht
ambushv	ambushv
amerdar2	amerdar2
amerdart	amerdart
amidar	amidar
amidarb	amidarb
amidaro	amidaro
amidars	amidars
amidaru	amidaru
amigo	amigo
ampkr2b1	ampkr2b1
ampkr2b2	ampkr2b2
ampkr2b3	ampkr2b3
ampkr95	ampkr95
ampoker2	ampoker2
amspdwy	amspdwy
amspdwya	amspdwya
amuse	amuse
androdun	androdun
andromed	andromed
angelkds	angelkds
animaljr	animaljr
anteater	anteater
anteatg	anteatg
anteatgb	anteatgb
aodk	aodk
aof	aof
aof2	aof2
aof2a	aof2a
aof3	aof3
aof3k	aof3k
apache3	apache3
apb	apb
apb1	apb1
apb2	apb2
apb3	apb3
apb4	apb4
apb5	apb5
apb6	apb6
apbf	apbf
apbg	apbg
aplatoon	aplatoon
aponow	aponow
apparel	apparel
apple10	apple10
appoooh	appoooh
aquajack	aquajack
aquajckj	aquajckj
aquarium	aquarium
aquarush	aquarush
ar_airh	ar_airh
ar_bios	ar_bios
ar_bowl	ar_bowl
ar_dart	ar_dart
ar_fast	ar_fast
ar_ldrb	ar_ldrb
ar_ldrba	ar_ldrba
ar_ninj	ar_ninj
ar_rdwr	ar_rdwr
ar_sdwr	ar_sdwr
ar_socc	ar_socc
ar_spot	ar_spot
ar_sprg	ar_sprg
ar_xeon	ar_xeon
arabfgt	arabfgt
arabfgtj	arabfgtj
arabfgtu	arabfgtu
arabiamj	arabiamj
arabiamu	arabiamu
arabian	arabian
arabiana	arabiana
arabianm	arabianm
arbalest	arbalest
arcadecl	arcadecl
arcadia	arcadia
archriv2	archriv2
archrivl	archrivl
area51	area51
area51a	area51a
area51mx	area51mx
area51t	area51t
area88	area88
arescue	arescue
argus	argus
argusg	argusg
arian	arian
ark1ball	ark1ball
arkangc	arkangc
arkangc2	arkangc2
arkanoid	arkanoid
arkarea	arkarea
arkatayt	arkatayt
arkatour	arkatour
arkbloc2	arkbloc2
arkblock	arkblock
arkgcbl	arkgcbl
arkmcubl	arkmcubl
arknid2j	arknid2j
arknid2u	arknid2u
arknoid2	arknoid2
arknoidj	arknoidj
arknoidu	arknoidu
arknoiuo	arknoiuo
arkretrn	arkretrn
arktayt2	arktayt2
arlingtn	arlingtn
armchm2o	armchm2o
armchmp2	armchmp2
armedf	armedf
armora	armora
armorap	armorap
armorar	armorar
armorca2	armorca2
armorcar	armorcar
armwar	armwar
armwara	armwara
armwarr1	armwarr1
armwaru	armwaru
armwrest	armwrest
ashnojoe	ashnojoe
ashura	ashura
ashurau	ashurau
aso	aso
assault	assault
assaultj	assaultj
assaultp	assaultp
astdelu1	astdelu1
astdelu2	astdelu2
astdelux	astdelux
asterix	asterix
asterock	asterock
asteroi1	asteroi1
asteroib	asteroib
asteroid	asteroid
astinvad	astinvad
astorm	astorm
astorm3	astorm3
astormb2	astormb2
astormbl	astormbl
astormj	astormj
astormu	astormu
astrass	astrass
astrob	astrob
astrob1	astrob1
astrob2	astrob2
astrob2a	astrob2a
astrof	astrof
astrof2	astrof2
astrof3	astrof3
astrofl	astrofl
astron	astron
astronp	astronp
astropal	astropal
astrowar	astrowar
astrxeaa	astrxeaa
astrxeac	astrxeac
astyanax	astyanax
asuka	asuka
asukaj	asukaj
asurabld	asurabld
asurabus	asurabus
asylum	asylum
atarifb	atarifb
atarifb1	atarifb1
atarifb4	atarifb4
ataxx	ataxx
ataxxa	ataxxa
ataxxj	ataxxj
atehate	atehate
atetckt2	atetckt2
atetcktl	atetcktl
atetris	atetris
atetrisa	atetrisa
atetrisb	atetrisb
atetrsb2	atetrsb2
athena	athena
atlantis	atlantis
atlantol	atlantol
atlants2	atlants2
atluspsx	atluspsx
atomboy	atomboy
atomboya	atomboya
atomicp	atomicp
atompunk	atompunk
atpsx	atpsx
attckufo	attckufo
aurail	aurail
aurail1	aurail1
aurailj	aurailj
av2mj1bb	av2mj1bb
av2mj2rg	av2mj2rg
avalnche	avalnche
avenger2	avenger2
avengers	avengers
avengrgj	avengrgj
avengrgs	avengrgs
avsp	avsp
avspa	avspa
avsph	avsph
avspirit	avspirit
avspj	avspj
avspu	avspu
awbios	awbios
aztarac	aztarac
azurian	azurian
backfira	backfira
backfire	backfire
backgamn	backgamn
baddudes	baddudes
badlandb	badlandb
badlands	badlands
bagman	bagman
bagmanmc	bagmanmc
bagmans	bagmans
bagmans2	bagmans2
bagnard	bagnard
bagnarda	bagnarda
bakatono	bakatono
bakubaku	bakubaku
bakubrkr	bakubrkr
bakuhatu	bakuhatu
bakutotu	bakutotu
balcube	balcube
ballbomb	ballbomb
ballbros	ballbros
balonfgt	balonfgt
baluba	baluba
bam2	bam2
bananadr	bananadr
banbam	banbam
bandido	bandido
bang	bang
bangball	bangball
bangbead	bangbead
bangj	bangj
bankp	bankp
baraduke	baraduke
barricad	barricad
barrier	barrier
basebal2	basebal2
bass	bass
bassangl	bassangl
batcir	batcir
batcira	batcira
batcirj	batcirj
batlbala	batlbala
batlball	batlball
batlbalu	batlbalu
batlbubl	batlbubl
batman	batman
batman2	batman2
batmanfr	batmanfr
batrider	batrider
batridra	batridra
batridrk	batridrk
batsugna	batsugna
batsugun	batsugun
battlan2	battlan2
battlan3	battlan3
battlane	battlane
battlcry	battlcry
battlera	battlera
battles	battles
battlex	battlex
battlntj	battlntj
battlnts	battlnts
battroad	battroad
batugnsp	batugnsp
bayrout1	bayrout1
bayroute	bayroute
bayroutj	bayroutj
bayrtbl1	bayrtbl1
bayrtbl2	bayrtbl2
bbakradu	bbakradu
bbakraid	bbakraid
bballoon	bballoon
bballs	bballs
bbbxing	bbbxing
bbmanw	bbmanw
bbmanwj	bbmanwj
bbonk	bbonk
bbprot	bbprot
bbros	bbros
bbusters	bbusters
bchopper	bchopper
bcrusher	bcrusher
bcruzm12	bcruzm12
bcstry	bcstry
bcstrya	bcstrya
bctvidbs	bctvidbs
beaminv	beaminv
beaminva	beaminva
beastf	beastf
beastrzb	beastrzb
beastrzr	beastrzr
beathead	beathead
beautyb	beautyb
beeline	beeline
beezer	beezer
beezer1	beezer1
bel	bel
benberob	benberob
berabohm	berabohm
beraboho	beraboho
berlwall	berlwall
berlwalt	berlwalt
bermudaa	bermudaa
bermudat	bermudat
berzerk	berzerk
berzerk1	berzerk1
bestbest	bestbest
bestleag	bestleag
bestri	bestri
bgaregcn	bgaregcn
bgaregga	bgaregga
bgareghk	bgareghk
bgaregnv	bgaregnv
bgaregt2	bgaregt2
bigappg	bigappg
bigbang	bigbang
bigbucks	bigbucks
bigd2	bigd2
bigdeal	bigdeal
bigdealb	bigdealb
bigevglf	bigevglf
bigevglj	bigevglj
bigfghtr	bigfghtr
bigfight	bigfight
bigkarnk	bigkarnk
bigkong	bigkong
bigprowr	bigprowr
bigrun	bigrun
bigstrik	bigstrik
bigstrkb	bigstrkb
bigtwin	bigtwin
bijokkog	bijokkog
bijokkoy	bijokkoy
billiard	billiard
bioatack	bioatack
biofreak	biofreak
biomtoy	biomtoy
bionicc	bionicc
bionicc1	bionicc1
bionicc2	bionicc2
bioship	bioship
birdtry	birdtry
bishi	bishi
bishjan	bishjan
bjourney	bjourney
bjtwin	bjtwin
bjtwina	bjtwina
bking	bking
bking2	bking2
bking3	bking3
bkrtmaq	bkrtmaq
bktigerb	bktigerb
blackt96	blackt96
bladestl	bladestl
bladstle	bladstle
blandia	blandia
blandiap	blandiap
blast30	blast30
blasted	blasted
blaster	blaster
blastkit	blastkit
blasto	blasto
blastoff	blastoff
blazeon	blazeon
blazer	blazer
blazlaz	blazlaz
blazstar	blazstar
blckgalb	blckgalb
blckout2	blckout2
blckoutj	blckoutj
bldwolf	bldwolf
bldwolfj	bldwolfj
bldyror2	bldyror2
blitz	blitz
blitz11	blitz11
blitz2k	blitz2k
blitz99	blitz99
blkbustr	blkbustr
blkdrgnb	blkdrgnb
blkdrgon	blkdrgon
blkhearj	blkhearj
blkheart	blkheart
blkhole	blkhole
blkpnthr	blkpnthr
blktiger	blktiger
blktouch	blktouch
blmbycar	blmbycar
blmbycau	blmbycau
block	block
blockade	blockade
blockbl	blockbl
blockcar	blockcar
blocken	blocken
blockgal	blockgal
blockhl	blockhl
blockj	blockj
blockjoy	blockjoy
blockout	blockout
bloodbra	bloodbra
bloodbro	bloodbro
bloods11	bloods11
bloods21	bloods21
bloods22	bloods22
bloodstm	bloodstm
bloodwar	bloodwar
bloxeed	bloxeed
bloxeedc	bloxeedc
bloxeedu	bloxeedu
blsthead	blsthead
blstroi2	blstroi2
blstroi3	blstroi3
blstroid	blstroid
blstroig	blstroig
blswhstl	blswhstl
bluehawk	bluehawk
bluehawn	bluehawn
blueprnj	blueprnj
blueprnt	blueprnt
blueshrk	blueshrk
blzntrnd	blzntrnd
bm1stmix	bm1stmix
bm2ndmix	bm2ndmix
bm2ndmxa	bm2ndmxa
bm3rdmix	bm3rdmix
bm4thmix	bm4thmix
bm5thmix	bm5thmix
bm6thmix	bm6thmix
bm7thmix	bm7thmix
bmaster	bmaster
bmcbowl	bmcbowl
bmclubmx	bmclubmx
bmcompm2	bmcompm2
bmcompmx	bmcompmx
bmcorerm	bmcorerm
bmdct	bmdct
bmfinal	bmfinal
bnglngby	bnglngby
bnj	bnj
bnstars	bnstars
bnstars1	bnstars1
bnzabros	bnzabros
bnzabrsj	bnzabrsj
boblbobl	boblbobl
bodyslam	bodyslam
bogeyman	bogeyman
boggy84	boggy84
bombbee	bombbee
bombjac2	bombjac2
bombjack	bombjack
bombkick	bombkick
bomblord	bomblord
bombrman	bombrman
bombsa	bombsa
bongo	bongo
bonkadv	bonkadv
bonzeado	bonzeado
bonzeadu	bonzeadu
bonzeadv	bonzeadv
boobhack	boobhack
boogwina	boogwina
boogwing	boogwing
boomrana	boomrana
boomrang	boomrang
bootcamp	bootcamp
boothill	boothill
borench	borench
borntofi	borntofi
bosco	bosco
boscomd	boscomd
boscomdo	boscomdo
boscoo	boscoo
boscoo2	boscoo2
botanic	botanic
botss	botss
bottom9	bottom9
bottom9n	bottom9n
bouldash	bouldash
bouldshj	bouldshj
bounty	bounty
bowl3d	bowl3d
bowler	bowler
bowlrama	bowlrama
boxer	boxer
boxingb	boxingb
boxingm	boxingm
boxyboy	boxyboy
bradley	bradley
brain	brain
brapboyj	brapboyj
brapboys	brapboys
brdrlinb	brdrlinb
brdrline	brdrline
brdrlins	brdrlins
breakers	breakers
breakrev	breakrev
breywood	breywood
brickyrd	brickyrd
brickzn	brickzn
brickzn3	brickzn3
brival	brival
brivalj	brivalj
brix	brix
brkthru	brkthru
brkthruj	brkthruj
bronx	bronx
brubber	brubber
brutforc	brutforc
brvblade	brvblade
bshark	bshark
bsharkj	bsharkj
bsktball	bsktball
bssoccer	bssoccer
bstars	bstars
bstars2	bstars2
btchamp	btchamp
btime	btime
btime2	btime2
btimem	btimem
btlecity	btlecity
btlfield	btlfield
btlfildb	btlfildb
btlkroad	btlkroad
btltryst	btltryst
btoads	btoads
bub68705	bub68705
bubblem	bubblem
bubblemj	bubblemj
bubbles	bubbles
bubblesp	bubblesp
bubblesr	bubblesr
bubbletr	bubbletr
bubbobr1	bubbobr1
bubl2000	bubl2000
bublbob1	bublbob1
bublbob2	bublbob2
bublbobl	bublbobl
bublbobr	bublbobr
bubsympb	bubsympb
bubsympe	bubsympe
bubsymph	bubsymph
bubsympu	bubsympu
buccanra	buccanra
buccanrs	buccanrs
buckrog	buckrog
buckrogn	buckrogn
bucky	bucky
buckyua	buckyua
buggybjr	buggybjr
buggyboy	buggyboy
buggychl	buggychl
buggycht	buggycht
bullet	bullet
bullfgt	bullfgt
bullfgtr	bullfgtr
bullfgts	bullfgts
bullsdrt	bullsdrt
buraiken	buraiken
burglarx	burglarx
buriki	buriki
burnforc	burnforc
burnfrco	burnfrco
burningf	burningf
burningh	burningh
butasan	butasan
buzzard	buzzard
bwcasino	bwcasino
bwidow	bwidow
bwings	bwings
bwingsa	bwingsa
bwingso	bwingso
bzone	bzone
bzone2	bzone2
bzonec	bzonec
cabal	cabal
cabala	cabala
cabalbl	cabalbl
cabalus	cabalus
cabalus2	cabalus2
cabaret	cabaret
cachat	cachat
cadash	cadash
cadashf	cadashf
cadashi	cadashi
cadashj	cadashj
cadashu	cadashu
cafedoll	cafedoll
cafetime	cafetime
cairblad	cairblad
calibr50	calibr50
calipso	calipso
calorie	calorie
calorieb	calorieb
calspeda	calspeda
calspeed	calspeed
cameltrj	cameltrj
cameltry	cameltry
camltrua	camltrua
camltrya	camltrya
candance	candance
cannball	cannball
cannonb	cannonb
cannonb2	cannonb2
cannonbp	cannonbp
canvas	canvas
canyon	canyon
canyonp	canyonp
capbowl	capbowl
capbowl2	capbowl2
capbowl3	capbowl3
capbowl4	capbowl4
capcor	capcor
capitol	capitol
capsnk	capsnk
captaven	captaven
captavna	captavna
captavne	captavne
captavnj	captavnj
captavnu	captavnu
captavua	captavua
captavuu	captavuu
captcomb	captcomb
captcomj	captcomj
captcomm	captcomm
captcomu	captcomu
capunc	capunc
car2	car2
caractn	caractn
cardline	cardline
carjmbre	carjmbre
carnevil	carnevil
carnival	carnival
carnvckt	carnvckt
carpolo	carpolo
carrera	carrera
cartfury	cartfury
cascade	cascade
cashquiz	cashquiz
casino5	casino5
castfant	castfant
catacomb	catacomb
catapult	catapult
catch22	catch22
caterplr	caterplr
catmousa	catmousa
catnmous	catnmous
catt	catt
cavelon	cavelon
cavenger	cavenger
cawing	cawing
cawingj	cawingj
cawingr1	cawingr1
cawingu	cawingu
cbaj	cbaj
cball	cball
cbasebal	cbasebal
cbdash	cbdash
cbnj	cbnj
cbombers	cbombers
cbtime	cbtime
cburnrb2	cburnrb2
cburnrub	cburnrub
cbuster	cbuster
cbusterj	cbusterj
cbusterw	cbusterw
ccasino	ccasino
ccastle1	ccastle1
ccastle2	ccastle2
ccastle3	ccastle3
ccastlef	ccastlef
ccastleg	ccastleg
ccastlej	ccastlej
ccastlep	ccastlep
ccastles	ccastles
ccboot	ccboot
ccboot2	ccboot2
cchasm	cchasm
cchasm1	cchasm1
cclimber	cclimber
cclimbr2	cclimbr2
cclimbrj	cclimbrj
cclmbr2a	cclmbr2a
cclownz	cclownz
cd32	cd32
cdiscon1	cdiscon1
cecmatch	cecmatch
centipd2	centipd2
centipdb	centipdb
centiped	centiped
centtime	centtime
cerberus	cerberus
cexplore	cexplore
cfarm	cfarm
cfghtice	cfghtice
cflyball	cflyball
cgangpzj	cgangpzj
cgangpzl	cgangpzl
cgraplop	cgraplop
cgraplp2	cgraplp2
chainrec	chainrec
chaknpop	chaknpop
challeng	challeng
cham24	cham24
chameleo	chameleo
champb2a	champb2a
champbas	champbas
champbb2	champbb2
champbbj	champbbj
champbja	champbja
champbwl	champbwl
champwr	champwr
champwrj	champwrj
champwru	champwru
changela	changela
changes	changes
changesa	changesa
charlien	charlien
chasehq	chasehq
chasehqj	chasehqj
chboxing	chboxing
checkmaj	checkmaj
checkman	checkman
checkmat	checkmat
cheekyms	cheekyms
cheesech	cheesech
chelnov	chelnov
chelnovj	chelnovj
chelnovu	chelnovu
chewing	chewing
cheyenne	cheyenne
chikij	chikij
chiller	chiller
chimerab	chimerab
chinagat	chinagat
chinatwn	chinatwn
chindrac	chindrac
chindrag	chindrag
chindrah	chindrah
chinher2	chinher2
chinhero	chinhero
chinhert	chinhert
chinmoku	chinmoku
chinsan	chinsan
chmplst2	chmplst2
chokchok	chokchok
choko	choko
chopper	chopper
choppera	choppera
chopperb	chopperb
chplft	chplft
chplftb	chplftb
chplftbl	chplftbl
chqflag	chqflag
chqflagj	chqflagj
chugokur	chugokur
chukatai	chukatai
chukataj	chukataj
chukatau	chukatau
chwrestl	chwrestl
chwy	chwy
circus	circus
circusc	circusc
circusc2	circusc2
circusc3	circusc3
circuscc	circuscc
circusce	circusce
circusse	circusse
cischeat	cischeat
citybmrj	citybmrj
citybomb	citybomb
citycon	citycon
citycona	citycona
citylove	citylove
ckong	ckong
ckonga	ckonga
ckongalc	ckongalc
ckongb	ckongb
ckongg	ckongg
ckongjeu	ckongjeu
ckongo	ckongo
ckongs	ckongs
clapapa	clapapa
clapapa2	clapapa2
claypign	claypign
clayshoo	clayshoo
clbowl	clbowl
cleopatr	cleopatr
cliffhga	cliffhga
cliffhgr	cliffhgr
cloak	cloak
cloakfr	cloakfr
cloakgr	cloakgr
cloaksp	cloaksp
clocknch	clocknch
cloud9	cloud9
clowns	clowns
clowns1	clowns1
clshrdst	clshrdst
clshroad	clshroad
cltchitr	cltchitr
cltchtrj	cltchtrj
club90s	club90s
club90sa	club90sa
cluckypo	cluckypo
cluclu	cluclu
cluedo	cluedo
cluedo2	cluedo2
cluedo2c	cluedo2c
cm2841a	cm2841a
cm2v841	cm2v841
cmagica	cmagica
cmehyou	cmehyou
cmissnx	cmissnx
cmv801	cmv801
cndypuzl	cndypuzl
cnights2	cnights2
cnightst	cnightst
cninja	cninja
cninja1	cninja1
cninjau	cninjau
cntsteer	cntsteer
cobracmj	cobracmj
cobracom	cobracom
cobram3	cobram3
cobraseg	cobraseg
code1d	code1d
code1db	code1db
colmns97	colmns97
colony7	colony7
colony7a	colony7a
colt	colt
column2j	column2j
columns	columns
columns2	columns2
columnsj	columnsj
columnsu	columnsu
combasc	combasc
combascb	combascb
combascj	combascj
combasct	combasct
combat	combat
combh	combh
comebaby	comebaby
comg076	comg076
comg079	comg079
comg080	comg080
comg094	comg094
comg107	comg107
comg123	comg123
comg125	comg125
comg127	comg127
comg128	comg128
comg134	comg134
comg145	comg145
comg157	comg157
comg159	comg159
comg164	comg164
comg168	comg168
comg172	comg172
comg175	comg175
comg176	comg176
comg181	comg181
comg183	comg183
comg185	comg185
comg186	comg186
comg187	comg187
comg204	comg204
comg208	comg208
comg227	comg227
comg230	comg230
comg236	comg236
comg239	comg239
comg246	comg246
comg272a	comg272a
comg272b	comg272b
comg903d	comg903d
comg905d	comg905d
commandb	commandb
commandj	commandj
commando	commando
commandu	commandu
commandw	commandw
commsega	commsega
comotion	comotion
compglfo	compglfo
compgolf	compgolf
complexx	complexx
condor	condor
congo	congo
connect4	connect4
conquer	conquer
contcirc	contcirc
contcrcu	contcrcu
contcrua	contcrua
contra	contra
contra1	contra1
contrab	contrab
contraj	contraj
contrajb	contrajb
cookbib	cookbib
cookbib2	cookbib2
cookbib3	cookbib3
cookrace	cookrace
coolmini	coolmini
coolpool	coolpool
coolridr	coolridr
cop01	cop01
cop01a	cop01a
copsnrob	copsnrob
coronatn	coronatn
cosmccop	cosmccop
cosmica	cosmica
cosmica2	cosmica2
cosmicg	cosmicg
cosmicm2	cosmicm2
cosmicmo	cosmicmo
cosmo	cosmo
cosmogng	cosmogng
cosmognj	cosmognj
cosmos	cosmos
cotton	cotton
cotton2	cotton2
cottonbm	cottonbm
cottong	cottong
cottonj	cottonj
cottonu	cottonu
countrb2	countrb2
countrnb	countrnb
countrun	countrun
countryc	countryc
couple	couple
couplei	couplei
couplep	couplep
cowrace	cowrace
cpoker	cpoker
cpokert	cpokert
cppicf	cppicf
cppicf2	cppicf2
cprobowl	cprobowl
cprogolf	cprogolf
cprosocc	cprosocc
cptennis	cptennis
cpzn1	cpzn1
cpzn2	cpzn2
cr589fw	cr589fw
cr589fwa	cr589fwa
cracksht	cracksht
crash	crash
crater	crater
crazyblk	crazyblk
crazycop	crazycop
crazyfgt	crazyfgt
crazywar	crazywar
crbalon2	crbalon2
crbaloon	crbaloon
crgolf	crgolf
crgolfa	crgolfa
crgolfb	crgolfb
crgolfbt	crgolfbt
crgolfc	crgolfc
crgolfhi	crgolfhi
crime211	crime211
crimec	crimec
crimecj	crimecj
crimecu	crimecu
crimep2	crimep2
crimepat	crimepat
crimfght	crimfght
crimfgt2	crimfgt2
crimfgtj	crimfgtj
critcrsh	critcrsh
crkdown	crkdown
crkdownj	crkdownj
crkdownu	crkdownu
crmaze	crmaze
crmazea	crmazea
crmazeb	crmazeb
croquis	croquis
crospang	crospang
crossbld	crossbld
crossbow	crossbow
crshrac2	crshrac2
crshrace	crshrace
crsword	crsword
cruisin	cruisin
crush	crush
crush2	crush2
crush3	crush3
crush4	crush4
crushbl	crushbl
crushs	crushs
crusnexo	crusnexo
crusnu21	crusnu21
crusnu40	crusnu40
crusnusa	crusnusa
crusnw13	crusnw13
crusnw20	crusnw20
crusnw23	crusnw23
crusnwld	crusnwld
cryptklr	cryptklr
crysbios	crysbios
crysking	crysking
crystal2	crystal2
crystalg	crystalg
crzralla	crzralla
crzrallg	crzrallg
crzrally	crzrally
cscluba	cscluba
csclubh	csclubh
csclubj	csclubj
cscrtry	cscrtry
cscrtry2	cscrtry2
cshift	cshift
cshooter	cshooter
cshootre	cshootre
csilver	csilver
csilverj	csilverj
csk227it	csk227it
csk234it	csk234it
csmash	csmash
csmasho	csmasho
cspike	cspike
cspring1	cspring1
csprins1	csprins1
csprint	csprint
csprint1	csprint1
csprint2	csprint2
csprintf	csprintf
csprintg	csprintg
csprints	csprints
cstlevna	cstlevna
csuperas	csuperas
csweetht	csweetht
ct2k3sa	ct2k3sa
ct2k3sp	ct2k3sp
cterrani	cterrani
cthd2003	cthd2003
ctisland	ctisland
ctislnd2	ctislnd2
ctislnd3	ctislnd3
ctomaday	ctomaday
ctornado	ctornado
ctribb2	ctribb2
ctribe	ctribe
ctribe1	ctribe1
ctribeb	ctribeb
ctrpllrp	ctrpllrp
ctsttape	ctsttape
cubeqst	cubeqst
cubybop	cubybop
cuebrckj	cuebrckj
cuebrick	cuebrick
cultname	cultname
cultures	cultures
cuoreuno	cuoreuno
cupfinal	cupfinal
cupsoc	cupsoc
cupsocs	cupsocs
cupsocs2	cupsocs2
cupsocsb	cupsocsb
curvebal	curvebal
cutieq	cutieq
cvs2gd	cvs2gd
cworld	cworld
cworld2j	cworld2j
cybattlr	cybattlr
cyberb21	cyberb21
cyberb22	cyberb22
cyberb23	cyberb23
cyberb2p	cyberb2p
cyberba2	cyberba2
cyberbal	cyberbal
cyberbap	cyberbap
cyberbt	cyberbt
cyberbt1	cyberbt1
cyberlip	cyberlip
cybertnk	cybertnk
cybots	cybots
cybotsj	cybotsj
cybotsu	cybotsu
cybrcomm	cybrcomm
cybrcycc	cybrcycc
cybsled	cybsled
cybsledj	cybsledj
cyclshtg	cyclshtg
cyclwarr	cyclwarr
cyvern	cyvern
czeroize	czeroize
dacholer	dacholer
dadandrn	dadandrn
dai2kaku	dai2kaku
daikaiju	daikaiju
daimakai	daimakai
daimakr2	daimakr2
daioh	daioh
daireika	daireika
dairesya	dairesya
daisenpu	daisenpu
daiskiss	daiskiss
daitorid	daitorid
daiyogen	daiyogen
dakkochn	dakkochn
dambust	dambust
dambustr	dambustr
danceyes	danceyes
danchih	danchih
dangar	dangar
dangar2	dangar2
dangarb	dangarb
dangcurv	dangcurv
dangerz	dangerz
dangseed	dangseed
dankuga	dankuga
daraku	daraku
darius	darius
darius2	darius2
darius2d	darius2d
dariuse	dariuse
dariusg	dariusg
dariusgj	dariusgj
dariusgu	dariusgu
dariusgx	dariusgx
dariusj	dariusj
dariuso	dariuso
darkadv	darkadv
darkedge	darkedge
darkedgj	darkedgj
darkhleg	darkhleg
darkhors	darkhors
darkmist	darkmist
darkplnt	darkplnt
darksea1	darksea1
darkseaj	darkseaj
darkseal	darkseal
darksel2	darksel2
darktowr	darktowr
darkwar	darkwar
darthvdr	darthvdr
darwin	darwin
dassaul4	dassaul4
dassault	dassault
dayto2pe	dayto2pe
dayton93	dayton93
daytona	daytona
daytona2	daytona2
daytonam	daytonam
daytonas	daytonas
daytonat	daytonat
dazzler	dazzler
dbc	dbc
dblaxle	dblaxle
dbldyn	dbldyn
dbldynf	dbldynf
dblewing	dblewing
dblplay	dblplay
dblpoind	dblpoind
dblpoint	dblpoint
dbreed	dbreed
dbreed72	dbreed72
dbz	dbz
dbz2	dbz2
dbzvrvs	dbzvrvs
dcclub	dcclub
dcclubfd	dcclubfd
dcclubj	dcclubj
dcheese	dcheese
dcon	dcon
dd6809a	dd6809a
dday	dday
ddayc	ddayc
ddayjlc	ddayjlc
ddayjlca	ddayjlca
ddcrew	ddcrew
ddcrew1	ddcrew1
ddcrew2	ddcrew2
ddcrewj	ddcrewj
ddcrewu	ddcrewu
ddealer	ddealer
ddenlovb	ddenlovb
ddenlovr	ddenlovr
ddenlvrj	ddenlvrj
ddgn6809	ddgn6809
ddonpach	ddonpach
ddonpchj	ddonpchj
ddp2	ddp2
ddr2m	ddr2m
ddr2mc	ddr2mc
ddr2mc2	ddr2mc2
ddr2ml	ddr2ml
ddr3ma	ddr3ma
ddr3mj	ddr3mj
ddr3mk	ddr3mk
ddr3mka	ddr3mka
ddr3mp	ddr3mp
ddr4m	ddr4m
ddr4mj	ddr4mj
ddr4mp	ddr4mp
ddr4mps	ddr4mps
ddr4ms	ddr4ms
ddr4msj	ddr4msj
ddr5m	ddr5m
ddra	ddra
ddragn2u	ddragn2u
ddragnba	ddragnba
ddragnw1	ddragnw1
ddrago3b	ddrago3b
ddrago3j	ddrago3j
ddragon	ddragon
ddragon2	ddragon2
ddragon3	ddragon3
ddragonb	ddragonb
ddragonu	ddragonu
ddragonw	ddragonw
ddragoua	ddragoua
ddrbocd	ddrbocd
ddream95	ddream95
ddrextrm	ddrextrm
ddribble	ddribble
ddrj	ddrj
ddrja	ddrja
ddrjb	ddrjb
ddrmax	ddrmax
ddrmax2	ddrmax2
ddrs2k	ddrs2k
ddrs2kj	ddrs2kj
ddrsbm	ddrsbm
ddru	ddru
ddrusa	ddrusa
ddsom	ddsom
ddsoma	ddsoma
ddsomb	ddsomb
ddsomj	ddsomj
ddsomjr1	ddsomjr1
ddsomr1	ddsomr1
ddsomr2	ddsomr2
ddsomr3	ddsomr3
ddsomu	ddsomu
ddsomur1	ddsomur1
ddtod	ddtod
ddtoda	ddtoda
ddtodh	ddtodh
ddtodj	ddtodj
ddtodjr1	ddtodjr1
ddtodjr2	ddtodjr2
ddtodr1	ddtodr1
ddtodu	ddtodu
ddtodur1	ddtodur1
ddungeon	ddungeon
ddux	ddux
ddux1	ddux1
dduxbl	dduxbl
ddz	ddz
deadang	deadang
deadconj	deadconj
deadconx	deadconx
deadeye	deadeye
dealem	dealem
dealer	dealer
deathbrd	deathbrd
decocass	decocass
deerhuna	deerhuna
deerhunb	deerhunb
deerhunc	deerhunc
deerhunt	deerhunt
defcmnd	defcmnd
defence	defence
defendb	defendb
defender	defender
defendg	defendg
defendw	defendw
defense	defense
defndjeu	defndjeu
deltrace	deltrace
demndrgn	demndrgn
demoderb	demoderb
demoderm	demoderm
demon	demon
demoneye	demoneye
demonwl1	demonwl1
demonwl2	demonwl2
demonwl3	demonwl3
demonwl4	demonwl4
demonwld	demonwld
dendeg	dendeg
dendeg2	dendeg2
dendeg2x	dendeg2x
dendegx	dendegx
denjinmk	denjinmk
depthch	depthch
depthv1	depthv1
derbyoc	derbyoc
deroon	deroon
desert	desert
desertbr	desertbr
desertgu	desertgu
desertwr	desertwr
desterth	desterth
destroyr	destroyr
destryea	destryea
destryer	destryer
detatwin	detatwin
devilfsg	devilfsg
devilfsh	devilfsh
devilw	devilw
devstor2	devstor2
devstor3	devstor3
devstors	devstors
devzone	devzone
devzone2	devzone2
dfeveron	dfeveron
dharma	dharma
dharmak	dharmak
diamond	diamond
diehard	diehard
dietgo	dietgo
dietgoe	dietgoe
dietgoj	dietgoj
dietgou	dietgou
digdug	digdug
digdug2	digdug2
digdug2o	digdug2o
digduga1	digduga1
digdugat	digdugat
digdugb	digdugb
digger	digger
diggerc	diggerc
diggerma	diggerma
digsid	digsid
dimahoo	dimahoo
dimahoou	dimahoou
dingo	dingo
dingoe	dingoe
dino	dino
dinoj	dinoj
dinopic	dinopic
dinopic2	dinopic2
dinorex	dinorex
dinorexj	dinorexj
dinorexu	dinorexu
dinou	dinou
dirtdvla	dirtdvla
dirtdvls	dirtdvls
dirtfoxj	dirtfoxj
disco	disco
discoboy	discoboy
discof	discof
diverboy	diverboy
djboy	djboy
djboya	djboya
djboyj	djboyj
dkgenm72	dkgenm72
dkgensan	dkgensan
dkngjnrj	dkngjnrj
dkong	dkong
dkong3	dkong3
dkong3b	dkong3b
dkong3j	dkong3j
dkongjo	dkongjo
dkongjo1	dkongjo1
dkongjp	dkongjp
dkongjr	dkongjr
dkongjrb	dkongjrb
dkongjre	dkongjre
dkongjrj	dkongjrj
dkongjrm	dkongjrm
dkongo	dkongo
dlair	dlair
dlaira	dlaira
dlairb	dlairb
dlairc	dlairc
dlaird	dlaird
dlaire	dlaire
dlairf	dlairf
dleague	dleague
dleuro	dleuro
dlital	dlital
dmndrby	dmndrby
dmndrbya	dmndrbya
dmnfrnt	dmnfrnt
dmnfrnta	dmnfrnta
dmx	dmx
dmx2m	dmx2m
dmx2majp	dmx2majp
dncfrks	dncfrks
dnmtdeka	dnmtdeka
doa	doa
doa2	doa2
doa2m	doa2m
doaa	doaa
doapp	doapp
docastl2	docastl2
docastle	docastle
docastlo	docastlo
dockman	dockman
dodge	dodge
dodgem	dodgem
dogfgt	dogfgt
dogfgtj	dogfgtj
dogfight	dogfight
dogosoke	dogosoke
dogpatch	dogpatch
dogyuun	dogyuun
dokaben	dokaben
dokidoki	dokidoki
dokyusei	dokyusei
dokyusp	dokyusp
domino	domino
dominob	dominob
dominos	dominos
dommy	dommy
doncdoon	doncdoon
dondenmj	dondenmj
dondokdj	dondokdj
dondokdu	dondokdu
dondokod	dondokod
donpachi	donpachi
donpachk	donpachk
donpacjp	donpacjp
donpackr	donpackr
dorachan	dorachan
dorodon	dorodon
dorodon2	dorodon2
dorunrca	dorunrca
dorunru2	dorunru2
dorunruc	dorunruc
dorunrun	dorunrun
dotriku2	dotriku2
dotrikun	dotrikun
dotron	dotron
dotrona	dotrona
dotrone	dotrone
doubledr	doubledr
douni	douni
dowild	dowild
downtow2	downtow2
downtown	downtown
downtowp	downtowp
dplay	dplay
dquizgo	dquizgo
dquizgo2	dquizgo2
draco	draco
dragnblz	dragnblz
dragngun	dragngun
dragoona	dragoona
dragoonj	dragoonj
dragrace	dragrace
drakton	drakton
dreamwld	dreamwld
dremshpr	dremshpr
drgnbowl	drgnbowl
drgnbstr	drgnbstr
drgninja	drgninja
drgnmst	drgnmst
drgnunit	drgnunit
drgnwrld	drgnwrld
drgpunch	drgpunch
drgw2	drgw2
drgw2c	drgw2c
drgw2j	drgw2j
drgw3	drgw3
drgw3k	drgw3k
drgwrld3	drgwrld3
dribling	dribling
driblino	driblino
drifto94	drifto94
driftout	driftout
drius2do	drius2do
drivedge	drivedge
driveout	driveout
driveyes	driveyes
drivfrcb	drivfrcb
drivfrcg	drivfrcg
drivfrcp	drivfrcp
drktnjr	drktnjr
drmario	drmario
drmicro	drmicro
drmn	drmn
drmn2m	drmn2m
drmn2mpu	drmn2mpu
drmn3m	drmn3m
drtomy	drtomy
drtoppel	drtoppel
drtopplj	drtopplj
drtopplu	drtopplu
drw80pkr	drw80pkr
dsaber	dsaber
dsaberj	dsaberj
dsccr94j	dsccr94j
dsem2	dsem2
dsfdct	dsfdct
dsfdcta	dsfdcta
dsftkd	dsftkd
dsoccr94	dsoccr94
dspirit	dspirit
dspirita	dspirita
dspirito	dspirito
dstage	dstage
dstlk	dstlk
dstlka	dstlka
dstlku	dstlku
dstlkur1	dstlkur1
dualaslt	dualaslt
duckhunt	duckhunt
dumpmtmt	dumpmtmt
dungenmu	dungenmu
dungeonm	dungeonm
dunhuang	dunhuang
dunkmnia	dunkmnia
dunkmnic	dunkmnic
dunkshot	dunkshot
dwarfd	dwarfd
dybb99	dybb99
dybbnao	dybbnao
dyger	dyger
dygera	dygera
dynabb	dynabb
dynablsb	dynablsb
dynablst	dynablst
dynabomb	dynabomb
dynadice	dynadice
dynagear	dynagear
dynamcop	dynamcop
dynamski	dynamski
dynashot	dynashot
dyndek2b	dyndek2b
dyndeka2	dyndeka2
dynduke	dynduke
dyndukf	dyndukf
dynmcopb	dynmcopb
dynmcopc	dynmcopc
dynobop	dynobop
dynwar	dynwar
dynwarj	dynwarj
dynwaru	dynwaru
dzigzag	dzigzag
eagle	eagle
eagle2	eagle2
eagle3	eagle3
eaglshot	eaglshot
earthjkr	earthjkr
ebases	ebases
eca	eca
ecax	ecax
ecofghta	ecofghta
ecofghtr	ecofghtr
ecofghtu	ecofghtu
ecofgtu1	ecofgtu1
edf	edf
edfu	edfu
edrandy	edrandy
edrandy1	edrandy1
edrandy2	edrandy2
edrandyj	edrandyj
egghunt	egghunt
eggor	eggor
eggs	eggs
eggvent7	eggvent7
eggventr	eggventr
eggvntdx	eggvntdx
ehrgeiz	ehrgeiz
ehrgeiza	ehrgeiza
eightfrc	eightfrc
eightman	eightman
einning	einning
ejanhs	ejanhs
ejihon	ejihon
ejollyx5	ejollyx5
elandore	elandore
elecyoy2	elecyoy2
elecyoyo	elecyoyo
elephfam	elephfam
elephfmb	elephfmb
elevatob	elevatob
elevator	elevator
elgrande	elgrande
elim2	elim2
elim2a	elim2a
elim2c	elim2c
elim4	elim4
elim4p	elim4p
elvact2u	elvact2u
elvactr	elvactr
elvactrj	elvactrj
elvis	elvis
embargo	embargo
emeralda	emeralda
emeraldj	emeraldj
emerldja	emerldja
empcity	empcity
empcityj	empcityj
empcityu	empcityu
endurob2	endurob2
endurobl	endurobl
enduror	enduror
enduror1	enduror1
enforce	enforce
enigma2	enigma2
enigma2a	enigma2a
eprom	eprom
eprom2	eprom2
equites	equites
equitess	equitess
ertictac	ertictac
esb	esb
esckids	esckids
esckidsj	esckidsj
escounts	escounts
esh	esh
esha	esha
eshb	eshb
espial	espial
espialu	espialu
esprade	esprade
espradej	espradej
espradeo	espradeo
eswat	eswat
eswatbl	eswatbl
eswatj	eswatj
eswatu	eswatu
eto	eto
euro2k2	euro2k2
euro2k2a	euro2k2a
euroch92	euroch92
evilngt	evilngt
evilston	evilston
evosocc	evosocc
excelsr	excelsr
excitbkj	excitbkj
excitebk	excitebk
excthour	excthour
exctleag	exctleag
exctscc2	exctscc2
exctscca	exctscca
exctsccb	exctsccb
exctsccr	exctsccr
exedexes	exedexes
exerion	exerion
exerionb	exerionb
exeriont	exeriont
exerizrb	exerizrb
exodus	exodus
explbrkr	explbrkr
explorer	explorer
exprrada	exprrada
exprraid	exprraid
extdwnhl	extdwnhl
exterm	exterm
extrmatj	extrmatj
extrmatn	extrmatn
exvania	exvania
exzisus	exzisus
eyes	eyes
eyes2	eyes2
eyeszac	eyeszac
f15se	f15se
f15se21	f15se21
f1dream	f1dream
f1dreamb	f1dreamb
f1en	f1en
f1gp	f1gp
f1gp2	f1gp2
f1gpb	f1gpb
f1gpstar	f1gpstar
f1gpstr2	f1gpstr2
f1lap	f1lap
f1superb	f1superb
fa	fa
faceoff	faceoff
falcon	falcon
falconz	falconz
fantasia	fantasia
fantasy	fantasy
fantasyj	fantasyj
fantasyu	fantasyu
fantazia	fantazia
fantjour	fantjour
fantland	fantland
fantlnda	fantlnda
fantsia2	fantsia2
fantsy95	fantsy95
fantzn2	fantzn2
fantzon1	fantzon1
fantzone	fantzone
farmer	farmer
farwest	farwest
fashiong	fashiong
fastdraw	fastdraw
fastfred	fastfred
fastlane	fastlane
fatfursa	fatfursa
fatfursp	fatfursp
fatfurwa	fatfurwa
fatfury1	fatfury1
fatfury2	fatfury2
fatfury3	fatfury3
fax	fax
fax2	fax2
fbait2bc	fbait2bc
fbaitbc	fbaitbc
fbaitmc	fbaitmc
fbaitmca	fbaitmca
fbaitmcj	fbaitmcj
fbaitmcu	fbaitmcu
fbfrenzy	fbfrenzy
fcombat	fcombat
fcrash	fcrash
fenix	fenix
feversos	feversos
ffantasa	ffantasa
ffantasy	ffantasy
ffight	ffight
ffight2b	ffight2b
ffightj	ffightj
ffightj1	ffightj1
ffightj2	ffightj2
ffightu	ffightu
ffightua	ffightua
ffightub	ffightub
ffreveng	ffreveng
fghtatck	fghtatck
fghtbskt	fghtbskt
fghthist	fghthist
fghthsta	fghthsta
fghthstj	fghthstj
fghthstu	fghthstu
fgoal	fgoal
fgoala	fgoala
fgtlayer	fgtlayer
fhawk	fhawk
fhawkj	fhawkj
fhboxers	fhboxers
fieldday	fieldday
fightfev	fightfev
fightfva	fightfva
fightrol	fightrol
filetto	filetto
finalap2	finalap2
finalap3	finalap3
finalapb	finalapb
finalapc	finalapc
finalapd	finalapd
finalapo	finalapo
finalapr	finalapr
finalb	finalb
finalbj	finalbj
finalbny	finalbny
finalbu	finalbu
finalgdr	finalgdr
finalizb	finalizb
finalizr	finalizr
finallap	finallap
finalp2j	finalp2j
finalp3j	finalp3j
finalttr	finalttr
findlove	findlove
findout	findout
finehour	finehour
finfrl2j	finfrl2j
finfurl2	finfurl2
finlapjb	finlapjb
finlapjc	finlapjc
finlarch	finlarch
firebarr	firebarr
firebatl	firebatl
firebeas	firebeas
firehawk	firehawk
fireone	fireone
fireshrk	fireshrk
firetpbl	firetpbl
firetrap	firetrap
firetrk	firetrk
fishfren	fishfren
fitegol2	fitegol2
fitegolf	fitegolf
fitfight	fitfight
fitter	fitter
fiveside	fiveside
fixeighb	fixeighb
fixeight	fixeight
fjbuster	fjbuster
flameguj	flameguj
flamegun	flamegun
flashgal	flashgal
flashgla	flashgla
flicks1	flicks1
flicks2	flicks2
flicky	flicky
flickyo	flickyo
flipshot	flipshot
flipull	flipull
flkatck	flkatck
flower	flower
flowers	flowers
flstory	flstory
flstoryj	flstoryj
flyball	flyball
flyboy	flyboy
flyboyb	flyboyb
flytiger	flytiger
fmaniac3	fmaniac3
fncywld	fncywld
fnkyfish	fnkyfish
fntsia2a	fntsia2a
foodf	foodf
foodf2	foodf2
foodfc	foodfc
footchmp	footchmp
forcebrk	forcebrk
forgott1	forgott1
forgottn	forgottn
formatz	formatz
fort2b	fort2b
fort2ba	fort2ba
fortecar	fortecar
fourtrax	fourtrax
fpoint	fpoint
fpoint1	fpoint1
fpointbj	fpointbj
fpointbl	fpointbl
fredmem	fredmem
fredmemc	fredmemc
fredmemj	fredmemj
fredmesp	fredmesp
fredmeuk	fredmeuk
fredmeus	fredmeus
freekcb2	freekcb2
freekckb	freekckb
freekick	freekick
freeze	freeze
freezea2	freezea2
freezea3	freezea3
freezea4	freezea4
freezea5	freezea5
freezea6	freezea6
freezeat	freezeat
freezejp	freezejp
frenzy	frenzy
friskyt	friskyt
friskyta	friskyta
frogf	frogf
frogg	frogg
frogger	frogger
froggers	froggers
froggrmc	froggrmc
frogs	frogs
frogseg1	frogseg1
frogseg2	frogseg2
fromanc2	fromanc2
fromanc4	fromanc4
fromance	fromance
fromancr	fromancr
frontlin	frontlin
fround	fround
froundl	froundl
fshark	fshark
fsharkbt	fsharkbt
fsoccer	fsoccer
fsoccerb	fsoccerb
fsoccerj	fsoccerj
fstarfrc	fstarfrc
fswords	fswords
ftimpact	ftimpact
ftimpcta	ftimpcta
fullthrl	fullthrl
funkbeeb	funkbeeb
funkybee	funkybee
funkyfig	funkyfig
funkyjej	funkyjej
funkyjet	funkyjet
funnymou	funnymou
funybubc	funybubc
funybubl	funybubl
funystrp	funystrp
futflash	futflash
futspy	futspy
fvipers	fvipers
fvipers2	fvipers2
fx	fx
g13knd	g13knd
ga2	ga2
ga2j	ga2j
ga2u	ga2u
gaia	gaia
gaiapolj	gaiapolj
gaiapols	gaiapols
gaiapolu	gaiapolu
gaiden	gaiden
gakupara	gakupara
gakusai	gakusai
gakusai2	gakusai2
gal10ren	gal10ren
galag88j	galag88j
galaga	galaga
galaga3	galaga3
galaga3a	galaga3a
galaga3m	galaga3m
galaga88	galaga88
galagamf	galagamf
galagamk	galagamk
galagamw	galagamw
galagao	galagao
galap1	galap1
galap4	galap4
galapx	galapx
galastrm	galastrm
galaxbsf	galaxbsf
galaxi	galaxi
galaxia	galaxia
galaxiaj	galaxiaj
galaxian	galaxian
galaxyfg	galaxyfg
galaxygn	galaxygn
galaxyr	galaxyr
galaxyrp	galaxyrp
galgbios	galgbios
galhustl	galhustl
galivan	galivan
galivan2	galivan2
galkaika	galkaika
galkoku	galkoku
gallag	gallag
gallgall	gallgall
gallop	gallop
galmedes	galmedes
galmidw	galmidw
galmidwo	galmidwo
galpan2g	galpan2g
galpan2j	galpan2j
galpan2t	galpan2t
galpani2	galpani2
galpani3	galpani3
galpani4	galpani4
galpania	galpania
galpanic	galpanic
galpanis	galpanis
galpans2	galpans2
galpansu	galpansu
galsnew	galsnew
galsnewa	galsnewa
galsnewj	galsnewj
galspnbl	galspnbl
galtaito	galtaito
galturbo	galturbo
galxwar2	galxwar2
galxwars	galxwars
galxwart	galxwart
gamecstl	gamecstl
gametngk	gametngk
gamshara	gamshara
gangonta	gangonta
gangwarb	gangwarb
gangwars	gangwars
ganryu	ganryu
gaplus	gaplus
gaplusa	gaplusa
gapluso	gapluso
gardia	gardia
gardiab	gardiab
garogun	garogun
garou	garou
garoubl	garoubl
garouo	garouo
garoup	garoup
garuka	garuka
garyoret	garyoret
gatedom1	gatedom1
gatedoom	gatedoom
gatsbee	gatsbee
gaun22p1	gaun22p1
gaun22pg	gaun22pg
gaun2pg1	gaun2pg1
gaun2pj2	gaun2pj2
gaun2pr3	gaun2pr3
gaunt2	gaunt2
gaunt22p	gaunt22p
gaunt2g	gaunt2g
gaunt2p	gaunt2p
gaunt2pg	gaunt2pg
gaunt2pj	gaunt2pj
gauntd24	gauntd24
gauntdl	gauntdl
gauntg	gauntg
gauntgr3	gauntgr3
gauntgr6	gauntgr6
gauntgr8	gauntgr8
gauntj	gauntj
gauntj12	gauntj12
gauntl12	gauntl12
gauntleg	gauntleg
gauntlet	gauntlet
gauntr1	gauntr1
gauntr2	gauntr2
gauntr4	gauntr4
gauntr5	gauntr5
gauntr7	gauntr7
gauntr9	gauntr9
gaunts	gaunts
gaxeduel	gaxeduel
gberet	gberet
gberetb	gberetb
gblchmp	gblchmp
gbustera	gbustera
gbusters	gbusters
gcpinbal	gcpinbal
gdarius	gdarius
gdarius2	gdarius2
gdariusb	gdariusb
gdfs	gdfs
geebee	geebee
geebeeb	geebeeb
gekiretu	gekiretu
gekirido	gekirido
gekisou	gekisou
gekitsui	gekitsui
gemini	gemini
genix	genix
genpeitd	genpeitd
gensitou	gensitou
geostorm	geostorm
gepoker	gepoker
gepoker1	gepoker1
gepoker2	gepoker2
getbass	getbass
getstar	getstar
getstarj	getstarj
gfire2	gfire2
gforce2	gforce2
gforce2j	gforce2j
gghost	gghost
ggram2	ggram2
ggreats2	ggreats2
gground	gground
ggroundj	ggroundj
ghlpanic	ghlpanic
ghoshunt	ghoshunt
ghostb	ghostb
ghostb3	ghostb3
ghostlop	ghostlop
ghouls	ghouls
ghoulsu	ghoulsu
ghox	ghox
ghoxa	ghoxa
ghunter	ghunter
gigandes	gigandes
gigandsj	gigandsj
gigasb	gigasb
gigasm2b	gigasm2b
gigawing	gigawing
gijoe	gijoe
gijoej	gijoej
gijoeu	gijoeu
gimeabrk	gimeabrk
gingania	gingania
ginganin	ginganin
ginkun	ginkun
gionbana	gionbana
gjspace	gjspace
gladiatr	gladiatr
glass	glass
glass10	glass10
glass10a	glass10a
gldncrwn	gldncrwn
glfgreat	glfgreat
glfgretj	glfgretj
gloc	gloc
glocr360	glocr360
glprac2j	glprac2j
glprac2l	glprac2l
glpracr	glpracr
glpracr2	glpracr2
glpracr3	glpracr3
gmahou	gmahou
gmgalax	gmgalax
gmissile	gmissile
gnbarich	gnbarich
gng	gng
gnga	gnga
gngbl	gngbl
gngblita	gngblita
gngt	gngt
go2000	go2000
goal92	goal92
goaltogo	goaltogo
goalx3	goalx3
godzilla	godzilla
gogomile	gogomile
gogomilj	gogomilj
goindol	goindol
goindolk	goindolk
goindolu	goindolu
gokuparo	gokuparo
goldbug	goldbug
goldmeda	goldmeda
goldmedb	goldmedb
goldmedl	goldmedl
goldnab2	goldnab2
goldnabl	goldnabl
goldnax1	goldnax1
goldnax2	goldnax2
goldnax3	goldnax3
goldnaxe	goldnaxe
goldnaxj	goldnaxj
goldnaxu	goldnaxu
goldnpkb	goldnpkb
goldnpkr	goldnpkr
goldstar	goldstar
goldstbl	goldstbl
golgo13	golgo13
gollygho	gollygho
gomoku	gomoku
gondo	gondo
good	good
goodejaa	goodejaa
goodejan	goodejan
goonies	goonies
gorf	gorf
gorfpgm1	gorfpgm1
gorkans	gorkans
gotcha	gotcha
gotya	gotya
gowcaizr	gowcaizr
gp2quiz	gp2quiz
gp2se	gp2se
gpgolf	gpgolf
gpilots	gpilots
gpilotsh	gpilotsh
gprider	gprider
gprider1	gprider1
gpworld	gpworld
gradius	gradius
gradius2	gradius2
gradius3	gradius3
gradius4	gradius4
gram2000	gram2000
grandprx	grandprx
gratia	gratia
gratiaa	gratiaa
gravitar	gravitar
gravitr2	gravitr2
gravp	gravp
grchamp	grchamp
grdforce	grdforce
grdians	grdians
grdius2a	grdius2a
grdius2b	grdius2b
grdius3a	grdius3a
grdius3e	grdius3e
grdnstrm	grdnstrm
greatgun	greatgun
greatgur	greatgur
greenber	greenber
grescue	grescue
gridiron	gridiron
gridlee	gridlee
griffon	griffon
grindsta	grindsta
grindstm	grindstm
grndtour	grndtour
grobda	grobda
grobda2	grobda2
grobda3	grobda3
groovef	groovef
groundfx	groundfx
growl	growl
growlu	growlu
grtwall	grtwall
grudge	grudge
gryzor	gryzor
gryzora	gryzora
gs4002	gs4002
gs4002a	gs4002a
gseeker	gseeker
gseekerj	gseekerj
gseekeru	gseekeru
gslgr94u	gslgr94u
gslugrsj	gslugrsj
gstream	gstream
gstrik2	gstrik2
gstriker	gstriker
gsword	gsword
gsword2	gsword2
gt103	gt103
gt103a	gt103a
gt103a1	gt103a1
gt103a2	gt103a2
gt103a3	gt103a3
gt103a4	gt103a4
gt103aa	gt103aa
gt103ab	gt103ab
gt103asx	gt103asx
gt2k	gt2k
gt2ks100	gt2ks100
gt2kt500	gt2kt500
gt3d	gt3d
gt3dl191	gt3dl191
gt3dl192	gt3dl192
gt3ds192	gt3ds192
gt3dt211	gt3dt211
gt3dt231	gt3dt231
gt3dv14	gt3dv14
gt3dv15	gt3dv15
gt3dv16	gt3dv16
gt3dv17	gt3dv17
gt3dv18	gt3dv18
gt5	gt5
gt507uk	gt507uk
gt97	gt97
gt97s121	gt97s121
gt97t240	gt97t240
gt97t243	gt97t243
gt97v120	gt97v120
gt97v121	gt97v121
gt97v122	gt97v122
gt98	gt98
gt98s100	gt98s100
gt98t303	gt98t303
gt98v100	gt98v100
gt99	gt99
gt99s100	gt99s100
gt99t400	gt99t400
gtclassc	gtclassc
gtclassp	gtclassp
gtcls100	gtcls100
gteikob2	gteikob2
gteikokb	gteikokb
gteikoku	gteikoku
gtfrk11m	gtfrk11m
gtfrk3ma	gtfrk3ma
gtfrk3mb	gtfrk3mb
gtg	gtg
gtg2	gtg2
gtg2j	gtg2j
gtg2t	gtg2t
gtgt	gtgt
gticlub	gticlub
gticlub2	gticlub2
gticlubj	gticlubj
gtipoker	gtipoker
gtmr	gtmr
gtmr2	gtmr2
gtmr2a	gtmr2a
gtmr2u	gtmr2u
gtmra	gtmra
gtmre	gtmre
gtmrusa	gtmrusa
gtrfrk2m	gtrfrk2m
gtrfrk3m	gtrfrk3m
gtrfrk4m	gtrfrk4m
gtrfrk5m	gtrfrk5m
gtrfrk6m	gtrfrk6m
gtrfrk7m	gtrfrk7m
gtrfrks	gtrfrks
gtrfrksa	gtrfrksa
gtrfrksj	gtrfrksj
gtrfrksu	gtrfrksu
gtroyal	gtroyal
gtsers1	gtsers1
gtsers2	gtsers2
gtsers3	gtsers3
gtsers4	gtsers4
gtsers5	gtsers5
gtsers7	gtsers7
gtsersa	gtsersa
gtsersb	gtsersb
gtstarb1	gtstarb1
gtstarb2	gtstarb2
gtsuprem	gtsuprem
guab	guab
guab3	guab3
guardian	guardian
guiness	guiness
gulfstr2	gulfstr2
gulfstrm	gulfstrm
gulfwar2	gulfwar2
gumbo	gumbo
gunball	gunball
gunbird	gunbird
gunbird2	gunbird2
gunbirdj	gunbirdj
gunbirdk	gunbirdk
gunblade	gunblade
gunbulet	gunbulet
gunbustr	gunbustr
gundamex	gundamex
gundeala	gundeala
gundealr	gundealr
gundealt	gundealt
gundhara	gundhara
gundl94	gundl94
gunfight	gunfight
gunforc2	gunforc2
gunforce	gunforce
gunforcj	gunforcj
gunforcu	gunforcu
gunfronj	gunfronj
gunfront	gunfront
gunhohki	gunhohki
gunlock	gunlock
gunmast	gunmast
gunnail	gunnail
gunpey	gunpey
gunsmoka	gunsmoka
gunsmoke	gunsmoke
gunsmokj	gunsmokj
gunsmoku	gunsmoku
gururin	gururin
gussun	gussun
gutangtn	gutangtn
guts	guts
gutsn	gutsn
guwange	guwange
guzzler	guzzler
gwar	gwar
gwara	gwara
gwarb	gwarb
gwarj	gwarj
gwarrior	gwarrior
gwing2	gwing2
gwinga	gwinga
gwingj	gwingj
gypsyjug	gypsyjug
gyrodinc	gyrodinc
gyrodine	gyrodine
gyruss	gyruss
gyrussce	gyrussce
hachamf	hachamf
hachoo	hachoo
hal21	hal21
hal21j	hal21j
halley87	halley87
halleycj	halleycj
halleys	halleys
halleysc	halleysc
hanaawas	hanaawas
hanagumi	hanagumi
hanakanz	hanakanz
hanamai	hanamai
hanamomb	hanamomb
hanamomo	hanamomo
hanaoji	hanaoji
hanaroku	hanaroku
hanayara	hanayara
hangly	hangly
hangly2	hangly2
hangly3	hangly3
hangman	hangman
hangon	hangon
hangon1	hangon1
hangonjr	hangonjr
hangplt	hangplt
harddrb5	harddrb5
harddrb6	harddrb6
harddrc1	harddrc1
harddrcb	harddrcb
harddrcg	harddrcg
harddrg4	harddrg4
harddriv	harddriv
harddrj6	harddrj6
harddrv1	harddrv1
harddrv2	harddrv2
harddrv3	harddrv3
harddrvb	harddrvb
harddrvc	harddrvc
harddrvg	harddrvg
harddrvj	harddrvj
harddunj	harddunj
harddunk	harddunk
hardhat	hardhat
hardhea2	hardhea2
hardhead	hardhead
hardhedb	hardhedb
hardyard	hardyard
hardyd10	hardyd10
harem	harem
haremchl	haremchl
harley	harley
hasamu	hasamu
hatena	hatena
hatris	hatris
hattrick	hattrick
hayaosi1	hayaosi1
hayaosi2	hayaosi2
hayaosi3	hayaosi3
hbarrel	hbarrel
hbarrelw	hbarrelw
hcastle	hcastle
hcastlej	hcastlej
hcastleo	hcastleo
hcastljo	hcastljo
hcrash	hcrash
hcrashc	hcrashc
hdrivaip	hdrivaip
hdrivair	hdrivair
headon	headon
headon2	headon2
headonb	headonb
headoni	headoni
headons	headons
heartatk	heartatk
heatbrl	heatbrl
heatbrl2	heatbrl2
heatbrlo	heatbrlo
heatbrlu	heatbrlu
heatof11	heatof11
heberpop	heberpop
hedpanic	hedpanic
hedpanif	hedpanif
heiankyo	heiankyo
helifira	helifira
helifire	helifire
hellfir1	hellfir1
hellfir2	hellfir2
hellfire	hellfire
hellngt	hellngt
herbiedk	herbiedk
hero	hero
herodk	herodk
herodku	herodku
heuksun	heuksun
hexa	hexa
hexion	hexion
hexpool	hexpool
hexpoola	hexpoola
hfh	hfh
hginga	hginga
hgkairak	hgkairak
hgokou	hgokou
hharry	hharry
hharryu	hharryu
hidctch2	hidctch2
hidctch3	hidctch3
hidnctch	hidnctch
higemaru	higemaru
highspla	highspla
highsplt	highsplt
hiimpac3	hiimpac3
hiimpacp	hiimpacp
hiimpact	hiimpact
hikaru	hikaru
hipai	hipai
hippodrm	hippodrm
hiryuken	hiryuken
hishouza	hishouza
histryma	histryma
hitice	hitice
hitme	hitme
hitnmis2	hitnmis2
hitnmiss	hitnmiss
hjingi	hjingi
hkagerou	hkagerou
hmcompm2	hmcompm2
hmcompmx	hmcompmx
hmgeo	hmgeo
hnayayoi	hnayayoi
hncholms	hncholms
hnfubuki	hnfubuki
hng64	hng64
hngmnjpm	hngmnjpm
hnkochou	hnkochou
hnoridur	hnoridur
hoccer	hoccer
hoccer2	hoccer2
hod2bios	hod2bios
hogalley	hogalley
holeland	holeland
holo	holo
homerun	homerun
homo	homo
honeydol	honeydol
hook	hook
hookj	hookj
hooku	hooku
hoops95	hoops95
hoops96	hoops96
hopmappy	hopmappy
hopprobo	hopprobo
horekid	horekid
horekidb	horekidb
horizon	horizon
horshoes	horshoes
hotblock	hotblock
hotbubl	hotbubl
hotchase	hotchase
hotd	hotd
hotdebut	hotdebut
hotdogst	hotdogst
hotgm4ev	hotgm4ev
hotgmck	hotgmck
hotgmck3	hotgmck3
hotgmcki	hotgmcki
hotmemry	hotmemry
hotmind	hotmind
hotpinbl	hotpinbl
hotrod	hotrod
hotroda	hotroda
hotrodj	hotrodj
hotshock	hotshock
hotslot	hotslot
hotsmash	hotsmash
hourouki	hourouki
housemn2	housemn2
housemnq	housemnq
hparadis	hparadis
hpolym84	hpolym84
hpuncher	hpuncher
hrdtimea	hrdtimea
hrdtimes	hrdtimes
hsf2	hsf2
hsf2j	hsf2j
hshavoc	hshavoc
hstenn10	hstenn10
hstennis	hstennis
htchctch	htchctch
htengoku	htengoku
hthero	hthero
hthero93	hthero93
hthero94	hthero94
hthero95	hthero95
hthro95u	hthro95u
hunchbak	hunchbak
hunchbka	hunchbka
hunchbkd	hunchbkd
hunchbkg	hunchbkg
hunchbks	hunchbks
huncholy	huncholy
hustle	hustle
hustler	hustler
hustlerb	hustlerb
hvnsgate	hvnsgate
hvoltage	hvoltage
hvymetal	hvymetal
hvysmsh	hvysmsh
hvysmsha	hvysmsha
hwchamp	hwchamp
hwrace	hwrace
hydra	hydra
hydrap	hydrap
hydrap2	hydrap2
hyhoo	hyhoo
hyhoo2	hyhoo2
hyouban	hyouban
hyperath	hyperath
hyperpac	hyperpac
hyperpcb	hyperpcb
hyperspt	hyperspt
hyprdelj	hyprdelj
hyprdriv	hyprdriv
hyprduel	hyprduel
hypreac2	hypreac2
hypreact	hypreact
hyprolyb	hyprolyb
hyprolym	hyprolym
hypsptsp	hypsptsp
iceclimb	iceclimb
iceclmbj	iceclmbj
iceclmrj	iceclmrj
ichir	ichir
ichirj	ichirj
ichirjbl	ichirjbl
ichirk	ichirk
idhimitu	idhimitu
idolmj	idolmj
idsoccer	idsoccer
iemoto	iemoto
iemotom	iemotom
iganinju	iganinju
igmo	igmo
ikari	ikari
ikari3	ikari3
ikari3nr	ikari3nr
ikarijp	ikarijp
ikarijpb	ikarijpb
ikki	ikki
imekura	imekura
imgfight	imgfight
imolagp	imolagp
imsorry	imsorry
imsorryj	imsorryj
inca	inca
indianbt	indianbt
indy500	indy500
indy500d	indy500d
indyheat	indyheat
indytem2	indytem2
indytem3	indytem3
indytem4	indytem4
indytemc	indytemc
indytemd	indytemd
indytemp	indytemp
inferno	inferno
inquiztr	inquiztr
insector	insector
insectx	insectx
intcup94	intcup94
inthunt	inthunt
inthuntu	inthuntu
intrepi2	intrepi2
intrepid	intrepid
introdon	introdon
intrscti	intrscti
inttoote	inttoote
inufuku	inufuku
invad2ct	invad2ct
invaddlx	invaddlx
invader4	invader4
invaderl	invaderl
invaders	invaders
invadpt2	invadpt2
invadrmr	invadrmr
invasion	invasion
invasnab	invasnab
invasnv4	invasnv4
invds	invds
invho2	invho2
invinco	invinco
invrvnga	invrvnga
invrvnge	invrvnge
ipminva1	ipminva1
ipminvad	ipminvad
ippatsu	ippatsu
iqblock	iqblock
iqblocka	iqblocka
iqblockf	iqblockf
irobot	irobot
ironhors	ironhors
irrmaze	irrmaze
istellar	istellar
ixion	ixion
jack	jack
jack2	jack2
jack3	jack3
jackal	jackal
jackalj	jackalj
jackpool	jackpool
jackrab2	jackrab2
jackrabs	jackrabs
jackrabt	jackrabt
jailbrek	jailbrek
jailbrkb	jailbrkb
jajamaru	jajamaru
janbari	janbari
janjans1	janjans1
janjans2	janjans2
janoh	janoh
janptr96	janptr96
janshin	janshin
jantouki	jantouki
janyoup2	janyoup2
jchan	jchan
jchan2	jchan2
jcross	jcross
jdredd	jdredd
jdreddb	jdreddb
jdreddp	jdreddp
jedi	jedi
jetwave	jetwave
jgakuen	jgakuen
jigkmgri	jigkmgri
jin	jin
jingbell	jingbell
jitsupro	jitsupro
jituroku	jituroku
jjack	jjack
jjparad2	jjparad2
jjparads	jjparads
jjpoker	jjpoker
jjpokerb	jjpokerb
jjsquawk	jjsquawk
jleague	jleague
jockeygp	jockeygp
joemac	joemac
joemacr	joemacr
joemacra	joemacra
jogakuen	jogakuen
joinem	joinem
jojo	jojo
jojoalt	jojoalt
jojoaltn	jojoaltn
jojoba	jojoba
jojoban	jojoban
jojobane	jojobane
jojon	jojon
jokercrd	jokercrd
jokpoker	jokpoker
jollycrd	jollycrd
jollyjgr	jollyjgr
jolyc3x3	jolyc3x3
jolyc980	jolyc980
jolyccra	jolyccra
jolyccrb	jolyccrb
jolycdab	jolycdab
jolycdae	jolycdae
jolycdat	jolycdat
jolycdev	jolycdev
jolycdit	jolycdit
jolyjkra	jolyjkra
jolyjokr	jolyjokr
jongbou	jongbou
jongkyo	jongkyo
josvolly	josvolly
journey	journey
joust	joust
joust2	joust2
joustr	joustr
joustwr	joustwr
joyfulr	joyfulr
joyjoy	joyjoy
joyman	joyman
jpark	jpark
jpark3	jpark3
jpopnics	jpopnics
jrking	jrking
jrpacman	jrpacman
jrpacmbl	jrpacmbl
jsk	jsk
jspecter	jspecter
jspectr2	jspectr2
juju	juju
jujub	jujub
jumpbug	jumpbug
jumpbugb	jumpbugb
jumpcoas	jumpcoas
jumpcoat	jumpcoat
jumping	jumping
jumpkids	jumpkids
jumppop	jumppop
jumpshot	jumpshot
jumpshtp	jumpshtp
jungleh	jungleh
junglek	junglek
jungler	jungler
junglers	junglers
junglhbr	junglhbr
junglkj2	junglkj2
junofrst	junofrst
junofstg	junofstg
jyangoku	jyangoku
kabukikl	kabukikl
kabukiz	kabukiz
kabukizj	kabukizj
kageki	kageki
kagekia	kagekia
kagekij	kagekij
kaguya	kaguya
kaguya2	kaguya2
kaguya2f	kaguya2f
kaiserkj	kaiserkj
kaiserkn	kaiserkn
kaitei	kaitei
kaiteids	kaiteids
kaiteik	kaiteik
kaiunqz	kaiunqz
kakumei	kakumei
kakumei2	kakumei2
kamenrid	kamenrid
kamikaze	kamikaze
kamikcab	kamikcab
kanatuen	kanatuen
kangaroa	kangaroa
kangarob	kangarob
kangaroo	kangaroo
kaos	kaos
karatblj	karatblj
karatblu	karatblu
karatblz	karatblz
karatedo	karatedo
karatevs	karatevs
karatour	karatour
karianx	karianx
karnov	karnov
karnovj	karnovj
karnovr	karnovr
kazan	kazan
kbash	kbash
kbash2	kbash2
kbm	kbm
kbm2nd	kbm2nd
kbm3rd	kbm3rd
kchamp	kchamp
kchampvs	kchampvs
kdeadeye	kdeadeye
kdynastg	kdynastg
keithlcy	keithlcy
kengo	kengo
kf10thep	kf10thep
kf2k2mp	kf2k2mp
kf2k2mp2	kf2k2mp2
kf2k2pla	kf2k2pla
kf2k2pls	kf2k2pls
kf2k3bl	kf2k3bl
kf2k3bla	kf2k3bla
kf2k3pcb	kf2k3pcb
kf2k3pl	kf2k3pl
kf2k3upl	kf2k3upl
kf2k5uni	kf2k5uni
kick	kick
kickboy	kickboy
kickc	kickc
kicker	kicker
kickgoal	kickgoal
kickman	kickman
kicknrun	kicknrun
kicknruu	kicknruu
kickoff	kickoff
kickridr	kickridr
kidniki	kidniki
kidnikiu	kidnikiu
kikaioh	kikaioh
kikcubib	kikcubib
kikcubic	kikcubic
kikikai	kikikai
kikstart	kikstart
killbld	killbld
killbldt	killbldt
killcom	killcom
kingbalj	kingbalj
kingball	kingball
kingdmgp	kingdmgp
kingofb	kingofb
kingpin	kingpin
kingpinm	kingpinm
kinst	kinst
kinst13	kinst13
kinst14	kinst14
kinst2	kinst2
kinst210	kinst210
kinst211	kinst211
kinst213	kinst213
kinst2k3	kinst2k3
kinst2k4	kinst2k4
kinstb	kinstb
kinstp	kinstp
kirameki	kirameki
kirarast	kirarast
kisekaeh	kisekaeh
kisekaem	kisekaem
kittenk	kittenk
kiwame	kiwame
kiwames	kiwames
kizuna	kizuna
kkgalax	kkgalax
klax	klax
klax2	klax2
klax3	klax3
klaxd	klaxd
klaxj	klaxj
klaxp1	klaxp1
klaxp2	klaxp2
klondkp	klondkp
klxyj	klxyj
knckhead	knckhead
knckhedj	knckhedj
kncljoe	kncljoe
kncljoea	kncljoea
kngtmare	kngtmare
knightb	knightb
knights	knights
knightsj	knightsj
knightsu	knightsu
knockout	knockout
knpuzzle	knpuzzle
kod	kod
kodb	kodb
kodj	kodj
kodu	kodu
kodure	kodure
kof10th	kof10th
kof2000	kof2000
kof2000n	kof2000n
kof2001	kof2001
kof2001h	kof2001h
kof2002	kof2002
kof2003	kof2003
kof2k4se	kof2k4se
kof94	kof94
kof95	kof95
kof96	kof96
kof96h	kof96h
kof97	kof97
kof97a	kof97a
kof97pls	kof97pls
kof98	kof98
kof98k	kof98k
kof98n	kof98n
kof99	kof99
kof99a	kof99a
kof99e	kof99e
kof99n	kof99n
kof99p	kof99p
koftball	koftball
kog	kog
koikoi	koikoi
koikois	koikois
koikois2	koikois2
koinomp	koinomp
kokoroj2	kokoroj2
konam80a	konam80a
konam80j	konam80j
konam80k	konam80k
konam80s	konam80s
konam80u	konam80u
konami88	konami88
konamigt	konamigt
konamigv	konamigv
konamigx	konamigx
konek	konek
kopunch	kopunch
korinai	korinai
korinaim	korinaim
korokoro	korokoro
korosuke	korosuke
koshien	koshien
kosmokil	kosmokil
kothello	kothello
kotm	kotm
kotm2	kotm2
kotmh	kotmh
kouyakyu	kouyakyu
kov	kov
kov115	kov115
kov2	kov2
kov2106	kov2106
kov2p	kov2p
kovj	kovj
kovplus	kovplus
kovplusa	kovplusa
kovsh	kovsh
kram	kram
kram2	kram2
kram3	kram3
kroozr	kroozr
krull	krull
krzybowl	krzybowl
ksayakyu	ksayakyu
ktiger	ktiger
ktiger2	ktiger2
kuhga	kuhga
kungfub	kungfub
kungfub2	kungfub2
kungfud	kungfud
kungfum	kungfum
kungfut	kungfut
kungfuta	kungfuta
kuniokub	kuniokub
kuniokun	kuniokun
kurikina	kurikina
kurikinj	kurikinj
kurikint	kurikint
kurikinu	kurikinu
kurufev	kurufev
kviper	kviper
kyros	kyros
kyrosj	kyrosj
kyuhito	kyuhito
kyukaidk	kyukaidk
kyukaido	kyukaido
kyustrkr	kyustrkr
labyrunk	labyrunk
labyrunr	labyrunr
ladybgb2	ladybgb2
ladybug	ladybug
ladybugb	ladybugb
ladybugg	ladybugg
ladyfrog	ladyfrog
ladygolf	ladygolf
ladykill	ladykill
ladymstr	ladymstr
lagunar	lagunar
landbrk	landbrk
landbrka	landbrka
landgear	landgear
landmakr	landmakr
landmkrp	landmkrp
lans2004	lans2004
laperla	laperla
laperlag	laperlag
laser	laser
laser2k1	laser2k1
laserbas	laserbas
laserbat	laserbat
laserbsa	laserbsa
lasso	lasso
lasstixx	lasstixx
lastbh	lastbh
lastblad	lastblad
lastbld2	lastbld2
lastbldh	lastbldh
lastbrnj	lastbrnj
lastbrnx	lastbrnx
lastday	lastday
lastdaya	lastdaya
lastduel	lastduel
lastfero	lastfero
lastfght	lastfght
lastforg	lastforg
lastfork	lastfork
lastfort	lastfort
lastmisn	lastmisn
lastmsnj	lastmsnj
lastmsno	lastmsno
lastsold	lastsold
lasvegas	lasvegas
lazarian	lazarian
lazercmd	lazercmd
lbgrande	lbgrande
lbowling	lbowling
lckywldj	lckywldj
ldrun	ldrun
ldrun2	ldrun2
ldrun3	ldrun3
ldrun3jp	ldrun3jp
ldrun4	ldrun4
ldruna	ldruna
le2	le2
le2j	le2j
le2u	le2u
leadang	leadang
leaguemn	leaguemn
ledstorm	ledstorm
ledstrm2	ledstrm2
legend	legend
legendoh	legendoh
legendos	legendos
legion	legion
legionna	legionna
legionnu	legionnu
legiono	legiono
legofair	legofair
lemans24	lemans24
lemmings	lemmings
lemnangl	lemnangl
leprechn	leprechn
leprechp	leprechp
lethalej	lethalej
lethalen	lethalen
lethalj	lethalj
lethalth	lethalth
lethalua	lethalua
lethalux	lethalux
letheab	letheab
letheae	letheae
levers	levers
lghost	lghost
lghostu	lghostu
lgp	lgp
lgtnfgha	lgtnfgha
lgtnfght	lgtnfght
lgtnfghu	lgtnfghu
lhb	lhb
lhba	lhba
lhzb2	lhzb2
lhzb2a	lhzb2a
lhzb3	lhzb3
lhzb4	lhzb4
liberat2	liberat2
liberatb	liberatb
liberate	liberate
liberatr	liberatr
liblrabl	liblrabl
lifefrce	lifefrce
lifefrcj	lifefrcj
lightbr	lightbr
liquidk	liquidk
liquidku	liquidku
lithero	lithero
littlerb	littlerb
livegal	livegal
livequiz	livequiz
lizwiz	lizwiz
lkage	lkage
lkageb	lkageb
lkageb2	lkageb2
lkageb3	lkageb3
lkageo	lkageo
llander	llander
llander1	llander1
lluck3x3	lluck3x3
lluck4x1	lluck4x1
lnc	lnc
lockload	lockload
locklodu	locklodu
lockon	lockon
lockonc	lockonc
locomotn	locomotn
loderdfa	loderdfa
loderndf	loderndf
loffire	loffire
loffirej	loffirej
loffireu	loffireu
logger	logger
logicpr2	logicpr2
logicpro	logicpro
loht	loht
lohtb	lohtb
lohtb2	lohtb2
lohtj	lohtj
lomakai	lomakai
looper	looper
looping	looping
loopinga	loopinga
lordgun	lordgun
lordofk	lordofk
losttmbh	losttmbh
losttomb	losttomb
lostwrld	lostwrld
lostwsga	lostwsga
lotlot	lotlot
lottof2	lottof2
lottofun	lottofun
lovehous	lovehous
loverboy	loverboy
lrescue	lrescue
lrescuem	lrescuem
lresort	lresort
lsasquad	lsasquad
lsrquiz	lsrquiz
lsrquiz2	lsrquiz2
lstduela	lstduela
lstduelb	lstduelb
ltcasinn	ltcasinn
ltcasino	ltcasino
lucky74	lucky74
lucky74a	lucky74a
lucky8	lucky8
luckywld	luckywld
luctoday	luctoday
lunarba1	lunarba1
lunarbat	lunarbat
lupin3	lupin3
luplup	luplup
luplup29	luplup29
lvcards	lvcards
lvgirl94	lvgirl94
lvpoker	lvpoker
lwings	lwings
lwings2	lwings2
lwingsb	lwingsb
lwingsjp	lwingsjp
m4	m4
m660	m660
m660b	m660b
m660j	m660j
m79amb	m79amb
mac2bios	mac2bios
mace	mace
macea	macea
mach3	mach3
machbrkr	machbrkr
machomou	machomou
machridj	machridj
machridr	machridr
macross	macross
macross2	macross2
macrossp	macrossp
macsbios	macsbios
madalien	madalien
madalina	madalina
madball	madball
madballn	madballn
madcrash	madcrash
maddog	maddog
maddog2	maddog2
maddog21	maddog21
maddog22	maddog22
maddoga	maddoga
maddonna	maddonna
maddonnb	maddonnb
madgear	madgear
madgearj	madgearj
madmotor	madmotor
madshark	madshark
magdrop	magdrop
magdrop2	magdrop2
magdrop3	magdrop3
magdropp	magdropp
magerror	magerror
magic10	magic10
magic102	magic102
magic10a	magic10a
magicbua	magicbua
magicbub	magicbub
magiccda	magiccda
magiccdb	magiccdb
magiccrd	magiccrd
magicfly	magicfly
magicstk	magicstk
magix	magix
maglord	maglord
maglordh	maglordh
magmax	magmax
magspot	magspot
magspot2	magspot2
magworm	magworm
magzun	magzun
mahmajn	mahmajn
mahmajn2	mahmajn2
mahoudai	mahoudai
mahretsu	mahretsu
maiko	maiko
mainev2p	mainev2p
mainevt	mainevt
mainevto	mainevto
mainsnk	mainsnk
majest12	majest12
majrjhdx	majrjhdx
majs101b	majs101b
majtit2j	majtit2j
majtitl2	majtitl2
majtitle	majtitle
majtitlj	majtitlj
majuu	majuu
majxtal7	majxtal7
makaiden	makaiden
makaimuc	makaimuc
makaimug	makaimug
makaimur	makaimur
maketrax	maketrax
maketrxb	maketrxb
makyosen	makyosen
malzak	malzak
malzak2	malzak2
mangchi	mangchi
manhatan	manhatan
maniach	maniach
maniach2	maniach2
maniacsp	maniacsp
maniacsq	maniacsq
manxtt	manxtt
manybloc	manybloc
mappy	mappy
mappyj	mappyj
marble	marble
marble2	marble2
marble3	marble3
marble4	marble4
marineb	marineb
marinedt	marinedt
mariner	mariner
mario	mario
marioj	marioj
marioo	marioo
markham	markham
mars	mars
martmast	martmast
maruchan	maruchan
marukin	marukin
marukodq	marukodq
marvins	marvins
marvland	marvland
marvlanj	marvlanj
masao	masao
mastboy	mastboy
mastboyi	mastboyi
masterw	masterw
masterwu	masterwu
mastkin	mastkin
matchit	matchit
matchit2	matchit2
mating	mating
matinga	matinga
matmania	matmania
matrim	matrim
mausuke	mausuke
maxaflex	maxaflex
maxf_102	maxf_102
maxf_ng	maxf_ng
maxforce	maxforce
maxrpm	maxrpm
maya	maya
mayday	mayday
maydaya	maydaya
maydayb	maydayb
mayhem	mayhem
mayjin3	mayjin3
mayjinsn	mayjinsn
mayjisn2	mayjisn2
mayumi	mayumi
maze	maze
mazeinv	mazeinv
mazerbla	mazerbla
mazinger	mazinger
mblkjack	mblkjack
mbomberj	mbomberj
mbombrd	mbombrd
mbombrdj	mbombrdj
mbrush	mbrush
mcatadv	mcatadv
mcatadvj	mcatadvj
mchampda	mchampda
mchampdx	mchampdx
mcitylov	mcitylov
mcnpshnt	mcnpshnt
mcolors	mcolors
mcombat	mcombat
mcombata	mcombata
mcontest	mcontest
mdhorse	mdhorse
mdrawpkr	mdrawpkr
mdrink	mdrink
mechatt	mechatt
mechattu	mechattu
medlanes	medlanes
megab	megab
megabj	megabj
megadon	megadon
megaforc	megaforc
megaman	megaman
megaman2	megaman2
megamn2a	megamn2a
megaplay	megaplay
megat3	megat3
megat3te	megat3te
megat4	megat4
megat4a	megat4a
megat4te	megat4te
megat5	megat5
megat6	megat6
megatack	megatack
megatech	megatech
megaznik	megaznik
megazona	megazona
megazonb	megazonb
megazonc	megazonc
megazone	megazone
meijinsn	meijinsn
meikyuh	meikyuh
meikyuha	meikyuha
meosism	meosism
mercs	mercs
mercsj	mercsj
mercsu	mercsu
mercsua	mercsua
merlinmm	merlinmm
mermaid	mermaid
metafox	metafox
metalb	metalb
metalbj	metalbj
metamrph	metamrph
metamrpj	metamrpj
metamrpu	metamrpu
meteor	meteor
meteorho	meteorho
meteorts	meteorts
metlclsh	metlclsh
metlhawk	metlhawk
metlhwkj	metlhwkj
metlsavr	metlsavr
metmqstr	metmqstr
metrocra	metrocra
metrocrs	metrocrs
mexico86	mexico86
mf_achas	mf_achas
mf_bdash	mf_bdash
mf_brist	mf_brist
mf_flip	mf_flip
mfightc	mfightc
mfightcc	mfightcc
mfjump	mfjump
mfunclub	mfunclub
mgakuen	mgakuen
mgakuen2	mgakuen2
mgcldate	mgcldate
mgcldtex	mgcldtex
mgcrystj	mgcrystj
mgcrystl	mgcrystl
mgcrysto	mgcrysto
mgcs	mgcs
mgfx	mgfx
mgion	mgion
mgmen89	mgmen89
mgolf	mgolf
mgprem11	mgprem11
mhavoc	mhavoc
mhavoc2	mhavoc2
mhavocp	mhavocp
mhavocrv	mhavocrv
mhgaiden	mhgaiden
mhhonban	mhhonban
mia	mia
mia2	mia2
miaj	miaj
midnrun	midnrun
midres	midres
midresb	midresb
midresj	midresj
midresu	midresu
miexchng	miexchng
mightguy	mightguy
mightybj	mightybj
mikie	mikie
mikiehs	mikiehs
mikiej	mikiej
milliped	milliped
millpac	millpac
millsun	millsun
mimonkey	mimonkey
mimonsco	mimonsco
mimonscr	mimonscr
minasan	minasan
minefld	minefld
minesw4p	minesw4p
mineswpr	mineswpr
minferno	minferno
miniboy7	miniboy7
minigol2	minigol2
minigolf	minigolf
minivadr	minivadr
mirage	mirage
mirax	mirax
mirninja	mirninja
misncrft	misncrft
missb2	missb2
missile	missile
missile2	missile2
missmw96	missmw96
missw96	missw96
mizubaku	mizubaku
mj4simai	mj4simai
mjanbari	mjanbari
mjangels	mjangels
mjapinky	mjapinky
mjcamera	mjcamera
mjcamerb	mjcamerb
mjchuuka	mjchuuka
mjclinic	mjclinic
mjcomv1	mjcomv1
mjdchuka	mjdchuka
mjdejavu	mjdejavu
mjderngr	mjderngr
mjdialq2	mjdialq2
mjdiplob	mjdiplob
mjegolf	mjegolf
mjelct3	mjelct3
mjelct3a	mjelct3a
mjelctrb	mjelctrb
mjelctrn	mjelctrn
mjflove	mjflove
mjfocus	mjfocus
mjfocusm	mjfocusm
mjfriday	mjfriday
mjgottsu	mjgottsu
mjgottub	mjgottub
mjgtaste	mjgtaste
mjhokite	mjhokite
mjifb	mjifb
mjikaga	mjikaga
mjkinjas	mjkinjas
mjkjidai	mjkjidai
mjkoiura	mjkoiura
mjkojink	mjkojink
mjlaman	mjlaman
mjleague	mjleague
mjlstory	mjlstory
mjmyornt	mjmyornt
mjmyster	mjmyster
mjmyuniv	mjmyuniv
mjmywrld	mjmywrld
mjnanpaa	mjnanpaa
mjnanpas	mjnanpas
mjnanpau	mjnanpau
mjnatsu	mjnatsu
mjnquesb	mjnquesb
mjnquest	mjnquest
mjreach	mjreach
mjreach1	mjreach1
mjsikakb	mjsikakb
mjsikakc	mjsikakc
mjsikakd	mjsikakd
mjsikaku	mjsikaku
mjsister	mjsister
mjsiyoub	mjsiyoub
mjtensin	mjtensin
mjuraden	mjuraden
mjvegas	mjvegas
mjyougo	mjyougo
mjyuugi	mjyuugi
mjyuugia	mjyuugia
mjzoomin	mjzoomin
mk	mk
mk2	mk2
mk2chal	mk2chal
mk2r14	mk2r14
mk2r21	mk2r21
mk2r32	mk2r32
mk2r42	mk2r42
mk2r91	mk2r91
mk3	mk3
mk3r10	mk3r10
mk3r20	mk3r20
mk4	mk4
mk4a	mk4a
mkeibaou	mkeibaou
mkla1	mkla1
mkla2	mkla2
mkla3	mkla3
mkla4	mkla4
mkoiuraa	mkoiuraa
mkprot9	mkprot9
mkr4	mkr4
mkyawdim	mkyawdim
mladyhtr	mladyhtr
mlander	mlander
mlanding	mlanding
mmaiko	mmaiko
mmancp2u	mmancp2u
mmatrix	mmatrix
mmatrixj	mmatrixj
mmaulers	mmaulers
mmaze	mmaze
mmcamera	mmcamera
mmehyou	mmehyou
mmonkey	mmonkey
mmpanic	mmpanic
mmsikaku	mmsikaku
mnchmobl	mnchmobl
mnight	mnight
mnumber	mnumber
mocapb	mocapb
mocapbj	mocapbj
mocapglf	mocapglf
moegonta	moegonta
mofflott	mofflott
moguchan	moguchan
mogura	mogura
mole	mole
momoko	momoko
mongolnw	mongolnw
monkelf	monkelf
monkeyd	monkeyd
monster2	monster2
monsterb	monsterb
monsterz	monsterz
montecar	montecar
monymony	monymony
moo	moo
mooaa	mooaa
moobl	moobl
moonal2	moonal2
moonal2b	moonal2b
moonaln	moonaln
moonbase	moonbase
mooncmw	mooncmw
mooncrgx	mooncrgx
mooncrs2	mooncrs2
mooncrs3	mooncrs3
mooncrsa	mooncrsa
mooncrsb	mooncrsb
mooncrsg	mooncrsg
mooncrst	mooncrst
mooncrsu	mooncrsu
moonlght	moonlght
moonqsr	moonqsr
moonwar	moonwar
moonwara	moonwara
moonwarp	moonwarp
mooua	mooua
moremore	moremore
moremorp	moremorp
mosaic	mosaic
mosaica	mosaica
mosaicf2	mosaicf2
mosyougi	mosyougi
motofren	motofren
motofrft	motofrft
motofrmd	motofrmd
motomdft	motomdft
motorace	motorace
motoraid	motoraid
motos	motos
mouja	mouja
mouser	mouser
mouserc	mouserc
mp_bio	mp_bio
mp_col3	mp_col3
mp_gaxe2	mp_gaxe2
mp_gslam	mp_gslam
mp_mazin	mp_mazin
mp_shnb3	mp_shnb3
mp_soni2	mp_soni2
mp_sonic	mp_sonic
mp_sor2	mp_sor2
mp_twc	mp_twc
mpang	mpang
mpangj	mpangj
mpangu	mpangu
mpatrol	mpatrol
mpatrolw	mpatrolw
mplanets	mplanets
mplanuk	mplanuk
mpu4met0	mpu4met0
mpu4tst2	mpu4tst2
mpu4utst	mpu4utst
mquake	mquake
mrdo	mrdo
mrdofix	mrdofix
mrdot	mrdot
mrdoy	mrdoy
mrdrillr	mrdrillr
mrdrilr2	mrdrilr2
mrdrilrg	mrdrilrg
mrdu	mrdu
mrflea	mrflea
mrgoemon	mrgoemon
mrheli	mrheli
mrjong	mrjong
mrkougar	mrkougar
mrkougb	mrkougb
mrkougb2	mrkougb2
mrkougr2	mrkougr2
mrlo	mrlo
mrokumei	mrokumei
mrtnt	mrtnt
mrviking	mrviking
mrvikngj	mrvikngj
ms4plus	ms4plus
ms5pcb	ms5pcb
ms5plus	ms5plus
msbingo	msbingo
mschamp	mschamp
mscoutm	mscoutm
msgunda1	msgunda1
msgundam	msgundam
msh	msh
msha	msha
mshb	mshb
mshh	mshh
mshj	mshj
mshjr1	mshjr1
mshu	mshu
mshutlj2	mshutlj2
mshuttle	mshuttle
mshuttlj	mshuttlj
mshvsf	mshvsf
mshvsfa	mshvsfa
mshvsfa1	mshvsfa1
mshvsfb	mshvsfb
mshvsfb1	mshvsfb1
mshvsfh	mshvsfh
mshvsfj	mshvsfj
mshvsfj1	mshvsfj1
mshvsfj2	mshvsfj2
mshvsfu	mshvsfu
mshvsfu1	mshvsfu1
msisaac	msisaac
msjiken	msjiken
mslider	mslider
mslug	mslug
mslug2	mslug2
mslug3	mslug3
mslug3b6	mslug3b6
mslug3h	mslug3h
mslug4	mslug4
mslug5	mslug5
mslug5h	mslug5h
mslugx	mslugx
mspacmab	mspacmab
mspacman	mspacman
mspacmat	mspacmat
mspacmbe	mspacmbe
mspacmnf	mspacmnf
mspacpls	mspacpls
mspuzzle	mspuzzle
mspuzzlg	mspuzzlg
mspuzzln	mspuzzln
mstadium	mstadium
mstworld	mstworld
msword	msword
mswordj	mswordj
mswordr1	mswordr1
mswordu	mswordu
mt_aftrb	mt_aftrb
mt_arrow	mt_arrow
mt_astrm	mt_astrm
mt_astro	mt_astro
mt_asyn	mt_asyn
mt_bbros	mt_bbros
mt_beast	mt_beast
mt_cols	mt_cols
mt_crack	mt_crack
mt_eswat	mt_eswat
mt_fshrk	mt_fshrk
mt_fwrld	mt_fwrld
mt_gaxe	mt_gaxe
mt_gaxe2	mt_gaxe2
mt_ggolf	mt_ggolf
mt_gng	mt_gng
mt_gsocr	mt_gsocr
mt_kcham	mt_kcham
mt_lastb	mt_lastb
mt_mlh	mt_mlh
mt_mwalk	mt_mwalk
mt_mystd	mt_mystd
mt_orun	mt_orun
mt_parlg	mt_parlg
mt_revsh	mt_revsh
mt_shang	mt_shang
mt_shar2	mt_shar2
mt_shnbi	mt_shnbi
mt_smgp	mt_smgp
mt_soni2	mt_soni2
mt_sonia	mt_sonia
mt_sonic	mt_sonic
mt_srbb	mt_srbb
mt_stbld	mt_stbld
mt_stf	mt_stf
mt_tetri	mt_tetri
mt_tfor2	mt_tfor2
mt_tgolf	mt_tgolf
mt_tlbba	mt_tlbba
mt_wcsoc	mt_wcsoc
mt_wwar	mt_wwar
mtetrisc	mtetrisc
mtlchamp	mtlchamp
mtlchmp1	mtlchmp1
mtlchmpa	mtlchmpa
mtlchmpj	mtlchmpj
mtlchmpu	mtlchmpu
mtrap	mtrap
mtrap3	mtrap3
mtrap4	mtrap4
mtwins	mtwins
mugsmash	mugsmash
multchmk	multchmk
multchmp	multchmp
multigam	multigam
multigm3	multigm3
multigmb	multigmb
murogem	murogem
murogema	murogema
musobana	musobana
mustache	mustache
mustang	mustang
mustangb	mustangb
mustangs	mustangs
mutantf	mutantf
mutantf3	mutantf3
mutantf4	mutantf4
mutnat	mutnat
mv4in1	mv4in1
mvp	mvp
mvpj	mvpj
mvsca	mvsca
mvscar1	mvscar1
mvscb	mvscb
mvsch	mvsch
mvscj	mvscj
mvscjr1	mvscjr1
mvscu	mvscu
mwalk	mwalk
mwalkbl	mwalkbl
mwalkj	mwalkj
mwalku	mwalku
mwarr	mwarr
mx5000	mx5000
myangel	myangel
myangel2	myangel2
myangel3	myangel3
myfairld	myfairld
myhero	myhero
myherok	myherok
myqbert	myqbert
mysticm	mysticm
mysticri	mysticri
myststno	myststno
mystston	mystston
mystwarr	mystwarr
mystwaru	mystwaru
mzrblzra	mzrblzra
nagano98	nagano98
nam1975	nam1975
nametune	nametune
naname	naname
naomi	naomi
naomi2	naomi2
naomigd	naomigd
narc	narc
narc3	narc3
nastar	nastar
nastarw	nastarw
natodef	natodef
natodefa	natodefa
natsuiro	natsuiro
naughtya	naughtya
naughtyb	naughtyb
naughtyc	naughtyc
navarone	navarone
nbahangt	nbahangt
nbajam	nbajam
nbajamex	nbajamex
nbajamr2	nbajamr2
nbajamt1	nbajamt1
nbajamt2	nbajamt2
nbajamt3	nbajamt3
nbajamte	nbajamte
nbamht	nbamht
nbamht1	nbamht1
nbanfl	nbanfl
nbapbp	nbapbp
nbashowt	nbashowt
nbbatman	nbbatman
nclubv3	nclubv3
ncombat	ncombat
ncombath	ncombath
ncommand	ncommand
ncv1	ncv1
ncv1j	ncv1j
ncv1j2	ncv1j2
ncv2	ncv2
ncv2j	ncv2j
nebulray	nebulray
nebulryj	nebulryj
neckneck	neckneck
nekkyoku	nekkyoku
nemesis	nemesis
nemesuk	nemesuk
nemo	nemo
nemoj	nemoj
neobattl	neobattl
neobombe	neobombe
neocup98	neocup98
neodrift	neodrift
neogeo	neogeo
neomrdo	neomrdo
neruton	neruton
nettoqc	nettoqc
netwars	netwars
newapunk	newapunk
newfant	newfant
newpuc2	newpuc2
newpuc2b	newpuc2b
newpuckx	newpuckx
news	news
newsa	newsa
newsin7	newsin7
newtangl	newtangl
nextfase	nextfase
nflfoot	nflfoot
nghtstrj	nghtstrj
nghtstru	nghtstru
ngpgal	ngpgal
nhidctch	nhidctch
nibbler	nibbler
nibblera	nibblera
nibblerb	nibblerb
nibblero	nibblero
nightlov	nightlov
nightstr	nightstr
ninclown	ninclown
ninja	ninja
ninjak	ninjak
ninjak2a	ninjak2a
ninjak2b	ninjak2b
ninjakd2	ninjakd2
ninjakj	ninjakj
ninjaku	ninjaku
ninjakun	ninjakun
ninjamas	ninjamas
ninjaw	ninjaw
ninjawj	ninjawj
ninjemak	ninjemak
nitd	nitd
nitdbl	nitdbl
nitedrvr	nitedrvr
nitrobal	nitrobal
niyanpai	niyanpai
nkdodge	nkdodge
nkdodgeb	nkdodgeb
nmaster	nmaster
nmg5	nmg5
nmg5e	nmg5e
nmouse	nmouse
nmouseb	nmouseb
nmsengen	nmsengen
nndmseal	nndmseal
noahsark	noahsark
noboranb	noboranb
nomnlnd	nomnlnd
nomnlndg	nomnlndg
nost	nost
nostj	nostj
nostk	nostk
nouryoku	nouryoku
nov2001u	nov2001u
nova2001	nova2001
nprinces	nprinces
nprincsb	nprincsb
nprincso	nprincso
nprincsu	nprincsu
nrallyx	nrallyx
nratechu	nratechu
nslashej	nslashej
nslasher	nslasher
nslashes	nslashes
nspirit	nspirit
nspiritj	nspiritj
nss	nss
nss_actr	nss_actr
nss_adam	nss_adam
nss_aten	nss_aten
nss_con3	nss_con3
nss_fzer	nss_fzer
nss_lwep	nss_lwep
nss_ncaa	nss_ncaa
nss_rob3	nss_rob3
nss_skin	nss_skin
nss_smw	nss_smw
nss_ssoc	nss_ssoc
nss_sten	nss_sten
nstocker	nstocker
nstockr2	nstockr2
nsub	nsub
ntcash	ntcash
ntopstar	ntopstar
numanath	numanath
numanatj	numanatj
nunchaku	nunchaku
nwarr	nwarr
nwarrb	nwarrb
nwarrh	nwarrh
nwarru	nwarru
nyanpani	nyanpani
nycaptor	nycaptor
nyny	nyny
nynyg	nynyg
nzerotea	nzerotea
officeye	officeye
offroad	offroad
offroadc	offroadc
offroadt	offroadt
offrodc1	offrodc1
offrodc3	offrodc3
offtwalc	offtwalc
offtwall	offtwall
ogonsiro	ogonsiro
ohmygod	ohmygod
oigas	oigas
oisipuzl	oisipuzl
ojanko2	ojanko2
ojankoc	ojankoc
ojankohs	ojankohs
ojankoy	ojankoy
ojousan	ojousan
ojousanm	ojousanm
olds	olds
olds100	olds100
olds100a	olds100a
olibochu	olibochu
olysoc92	olysoc92
omega	omega
omegaf	omegaf
omegafs	omegafs
omegrace	omegrace
omni	omni
omotesnd	omotesnd
oneshot	oneshot
onetwo	onetwo
onetwoe	onetwoe
onna34ra	onna34ra
onna34ro	onna34ro
opaopa	opaopa
opengol2	opengol2
opengolf	opengolf
openice	openice
openmj	openmj
opwolf	opwolf
opwolf3	opwolf3
opwolf3u	opwolf3u
opwolfa	opwolfa
opwolfb	opwolfb
opwolfu	opwolfu
orangec	orangec
orangeci	orangeci
orbit	orbit
orbitron	orbitron
orbs	orbs
ordyne	ordyne
ordynej	ordynej
orld105k	orld105k
orld111c	orld111c
orlegend	orlegend
orlegndc	orlegndc
orlegnde	orlegnde
orunners	orunners
orunneru	orunneru
oscar	oscar
oscarj	oscarj
oscarj0	oscarj0
oscarj1	oscarj1
osman	osman
otatidai	otatidai
othellos	othellos
othldrby	othldrby
othunder	othunder
othundrj	othundrj
othundu	othundu
othunduo	othunduo
otonano	otonano
otrigger	otrigger
otwalls	otwalls
outfxesj	outfxesj
outfxies	outfxies
outline	outline
outrun	outrun
outrun1	outrun1
outrun2	outrun2
outrunb	outrunb
outzone	outzone
outzonea	outzonea
outzoneb	outzoneb
outzonec	outzonec
overdriv	overdriv
overrev	overrev
overtop	overtop
ozmawar2	ozmawar2
ozmawars	ozmawars
ozon1	ozon1
p47	p47
p47aces	p47aces
p47j	p47j
p911	p911
p9112	p9112
p911e	p911e
p911j	p911j
p911uc	p911uc
pacapp	pacapp
pacapp2	pacapp2
pacappsp	pacappsp
pacgal	pacgal
pacheart	pacheart
pachiten	pachiten
pacland	pacland
pacland2	pacland2
pacland3	pacland3
paclandm	paclandm
pacman	pacman
pacmanbl	pacmanbl
pacmanf	pacmanf
pacmania	pacmania
pacmanij	pacmanij
pacmod	pacmod
pacnchmp	pacnchmp
pacnpal	pacnpal
pacnpal2	pacnpal2
pacplus	pacplus
paddle2	paddle2
paddlema	paddlema
paintlad	paintlad
paintrlr	paintrlr
pairlove	pairlove
pairs	pairs
pairsa	pairsa
pairsnb	pairsnb
pairsten	pairsten
palamed	palamed
pandoras	pandoras
pang	pang
pang3	pang3
pang3j	pang3j
pangb	pangb
pangba	pangba
pangbold	pangbold
pangofun	pangofun
pangpang	pangpang
pangpomm	pangpomm
pangpoms	pangpoms
panic	panic
panic2	panic2
panic3	panic3
panicbom	panicbom
panicger	panicger
panich	panich
panicr	panicr
panicstr	panicstr
paperboy	paperboy
paperbr1	paperbr1
paperbr2	paperbr2
paprazzi	paprazzi
paradice	paradice
paradise	paradise
paradlx	paradlx
paranoia	paranoia
parodisj	parodisj
parodius	parodius
pasha2	pasha2
pass	pass
passht4b	passht4b
passsht	passsht
passshta	passshta
passshtb	passshtb
passshtj	passshtj
pastelg	pastelg
patimono	patimono
pbactio2	pbactio2
pbactio3	pbactio3
pbaction	pbaction
pballoon	pballoon
pbancho	pbancho
pbball96	pbball96
pbballex	pbballex
pbchmp95	pbchmp95
pbillian	pbillian
pbillrd	pbillrd
pbillrds	pbillrds
pblbeach	pblbeach
pbobbl2j	pbobbl2j
pbobbl2n	pbobbl2n
pbobbl2u	pbobbl2u
pbobbl2x	pbobbl2x
pbobbl3j	pbobbl3j
pbobbl3u	pbobbl3u
pbobbl4j	pbobbl4j
pbobbl4u	pbobbl4u
pbobble	pbobble
pbobble2	pbobble2
pbobble3	pbobble3
pbobble4	pbobble4
pbobblen	pbobblen
pbobblna	pbobblna
pc_1942	pc_1942
pc_bball	pc_bball
pc_bfght	pc_bfght
pc_bstar	pc_bstar
pc_cntra	pc_cntra
pc_cshwk	pc_cshwk
pc_cvnia	pc_cvnia
pc_dbldr	pc_dbldr
pc_ddrgn	pc_ddrgn
pc_drmro	pc_drmro
pc_duckh	pc_duckh
pc_ebike	pc_ebike
pc_ftqst	pc_ftqst
pc_gntlt	pc_gntlt
pc_golf	pc_golf
pc_goons	pc_goons
pc_grdue	pc_grdue
pc_grdus	pc_grdus
pc_hgaly	pc_hgaly
pc_kngfu	pc_kngfu
pc_mario	pc_mario
pc_miket	pc_miket
pc_mman3	pc_mman3
pc_moglf	pc_moglf
pc_mtoid	pc_mtoid
pc_ngai2	pc_ngai2
pc_ngai3	pc_ngai3
pc_ngaid	pc_ngaid
pc_pinbt	pc_pinbt
pc_pwbld	pc_pwbld
pc_pwrst	pc_pwrst
pc_radr2	pc_radr2
pc_radrc	pc_radrc
pc_rcpam	pc_rcpam
pc_rkats	pc_rkats
pc_rnatk	pc_rnatk
pc_rrngr	pc_rrngr
pc_rygar	pc_rygar
pc_sjetm	pc_sjetm
pc_smb	pc_smb
pc_smb2	pc_smb2
pc_smb3	pc_smb3
pc_suprc	pc_suprc
pc_tbowl	pc_tbowl
pc_tenis	pc_tenis
pc_tkfld	pc_tkfld
pc_tmnt	pc_tmnt
pc_tmnt2	pc_tmnt2
pc_trjan	pc_trjan
pc_vball	pc_vball
pc_wcup	pc_wcup
pc_wgnmn	pc_wgnmn
pc_ynoid	pc_ynoid
pcktgal	pcktgal
pcktgal2	pcktgal2
pcktgalb	pcktgalb
pcktgl2j	pcktgl2j
pclubj	pclubj
pclubjv2	pclubjv2
pclubjv4	pclubjv4
pclubjv5	pclubjv5
pclubys	pclubys
pclubysa	pclubysa
pcnfrk3m	pcnfrk3m
pdrift	pdrift
pdrifta	pdrifta
pdrifte	pdrifte
pdriftj	pdriftj
pebe0014	pebe0014
peekaboo	peekaboo
peepshow	peepshow
peggle	peggle
pegglet	pegglet
peke1012	peke1012
penbros	penbros
pengo	pengo
pengo2	pengo2
pengo2u	pengo2u
pengo3u	pengo3u
pengo4	pengo4
pengob	pengob
penta	penta
pepp0065	pepp0065
pepp0158	pepp0158
pepp0188	pepp0188
pepp0250	pepp0250
pepp0447	pepp0447
pepp0516	pepp0516
pepper2	pepper2
peps0014	peps0014
peps0022	peps0022
peps0043	peps0043
peps0045	peps0045
peps0308	peps0308
peps0615	peps0615
peps0716	peps0716
percuss	percuss
perestrf	perestrf
perestro	perestro
perfrman	perfrman
perfrmau	perfrmau
peset038	peset038
pestplce	pestplce
peterpak	peterpak
pettanp	pettanp
pex2069p	pex2069p
pexmp006	pexmp006
pexp0019	pexp0019
pexp0112	pexp0112
pexs0006	pexs0006
pf2012	pf2012
pfghtj	pfghtj
pgear	pgear
pgearr1	pgearr1
pgm	pgm
pgoal	pgoal
phantasm	phantasm
phantom2	phantom2
phantoma	phantoma
pharrier	pharrier
phelios	phelios
phoenix	phoenix
phoenix3	phoenix3
phoenixa	phoenixa
phoenixb	phoenixb
phoenixc	phoenixc
phoenixt	phoenixt
photof	photof
photoy2k	photoy2k
phozon	phozon
phrcraze	phrcraze
phrcrazs	phrcrazs
pickin	pickin
pignewt	pignewt
pignewta	pignewta
pigout	pigout
pigouta	pigouta
pigskin	pigskin
pinbo	pinbo
pinboa	pinboa
pinbos	pinbos
pingpong	pingpong
pipedrm	pipedrm
pipedrmj	pipedrmj
pipeline	pipeline
pipibibi	pipibibi
pipibibs	pipibibs
piranha	piranha
piranhah	piranhah
piranhao	piranhao
pirates	pirates
piratetr	piratetr
piratpet	piratpet
pisces	pisces
piscesb	piscesb
pistoldm	pistoldm
pitboss	pitboss
pitboss2	pitboss2
pitbossm	pitbossm
pitbosss	pitbosss
pitfall2	pitfall2
pitfalla	pitfalla
pitfallu	pitfallu
pitfigh3	pitfigh3
pitfigh4	pitfigh4
pitfighb	pitfighb
pitfighj	pitfighj
pitfight	pitfight
pitnrun	pitnrun
pitnruna	pitnruna
pjustic	pjustic
pkgnsh	pkgnsh
pkgnshdx	pkgnshdx
pkladiel	pkladiel
pkladies	pkladies
pkladila	pkladila
pkrdewin	pkrdewin
pkscram	pkscram
pktgaldb	pktgaldb
pktgaldj	pktgaldj
pktgaldx	pktgaldx
pkunwar	pkunwar
pkunwarj	pkunwarj
platoon	platoon
playball	playball
playch10	playch10
plctr13b	plctr13b
plegendj	plegendj
plegends	plegends
pleiadbl	pleiadbl
pleiadce	pleiadce
pleiads	pleiads
plgirls	plgirls
plgirls2	plgirls2
plottina	plottina
plottinb	plottinb
plotting	plotting
plottinu	plottinu
plsmaswd	plsmaswd
plsmswda	plsmswda
pltkids	pltkids
pltkidsa	pltkidsa
plumppop	plumppop
plusalph	plusalph
plygonet	plygonet
pmpoker	pmpoker
pmroulet	pmroulet
pnickj	pnickj
pntnpuzl	pntnpuzl
pnyaa	pnyaa
pocketrc	pocketrc
podrace	podrace
poitto	poitto
poizone	poizone
pokechmp	pokechmp
poker41	poker41
pokio	pokio
pokrdice	pokrdice
polaris	polaris
polarisa	polarisa
polepos	polepos
polepos1	polepos1
polepos2	polepos2
poleposa	poleposa
poleps2a	poleps2a
poleps2b	poleps2b
policetr	policetr
polict10	polict10
polict11	polict11
pollux	pollux
polluxa	polluxa
polluxa2	polluxa2
polyplay	polyplay
polystar	polystar
pompingw	pompingw
ponchin	ponchin
ponchina	ponchina
ponpoko	ponpoko
ponpokov	ponpokov
pontoon	pontoon
ponttehk	ponttehk
pool10	pool10
pool10b	pool10b
pool10c	pool10c
poolshrk	poolshrk
pootan	pootan
pooyan	pooyan
pooyans	pooyans
pop_hh	pop_hh
popbingo	popbingo
popbounc	popbounc
popeye	popeye
popeyebl	popeyebl
popeyef	popeyef
popeyeu	popeyeu
popflama	popflama
popflamb	popflamb
popflame	popflame
popflamn	popflamn
popn7	popn7
popn9	popn9
popnpop	popnpop
popnpopj	popnpopj
popnpopu	popnpopu
popper	popper
popspops	popspops
porky	porky
porter	porter
portman	portman
portrait	portrait
portrata	portrata
potgame	potgame
potogold	potogold
potopoto	potopoto
poundfoj	poundfoj
poundfor	poundfor
poundfou	poundfou
pow	pow
powerbal	powerbal
powerbls	powerbls
powerdrv	powerdrv
powerina	powerina
powerinb	powerinb
powerins	powerins
powj	powj
powrplay	powrplay
ppcar	ppcar
ppchamp	ppchamp
ppd	ppd
ppking	ppking
ppmast93	ppmast93
ppp	ppp
ppp11	ppp11
ppp2nd	ppp2nd
prehisle	prehisle
prehislu	prehislu
preisle2	preisle2
prikura	prikura
primella	primella
primglex	primglex
primrag2	primrag2
primraga	primraga
primrage	primrage
prmrsocj	prmrsocj
prmrsocr	prmrsocr
prmtmfgo	prmtmfgo
prmtmfgt	prmtmfgt
profpac	profpac
progear	progear
progeara	progeara
progearj	progearj
progolf	progolf
progolfa	progolfa
progress	progress
promutra	promutra
promutrb	promutrb
promutrc	promutrc
promutrv	promutrv
propcycl	propcycl
prosoccr	prosoccr
prosport	prosport
prtytime	prtytime
psailor1	psailor1
psailor2	psailor2
psarc95	psarc95
pshot16a	pshot16a
psoldier	psoldier
pspikes	pspikes
pspikes2	pspikes2
pspikesb	pspikesb
pspikesc	pspikesc
pspikesk	pspikesk
pstadium	pstadium
pstone	pstone
pstone2	pstone2
psurge	psurge
psychic5	psychic5
psychos	psychos
psychosj	psychosj
psyforce	psyforce
psyforcj	psyforcj
psyfrcex	psyfrcex
ptblank	ptblank
ptblank2	ptblank2
ptblnk2a	ptblnk2a
pturn	pturn
puchicar	puchicar
puchicrj	puchicrj
puckman	puckman
puckmana	puckmana
puckmanf	puckmanf
puckmanh	puckmanh
puckmod	puckmod
puckpepl	puckpepl
puckpkmn	puckpkmn
pulirula	pulirula
pulirulj	pulirulj
pulltabs	pulltabs
pulsar	pulsar
pulstar	pulstar
punchita	punchita
punchout	punchout
punipic	punipic
punipic2	punipic2
punipic3	punipic3
punisher	punisher
punishrj	punishrj
punishru	punishru
punkshot	punkshot
punksht2	punksht2
punkshtj	punkshtj
pururun	pururun
pushman	pushman
pushmana	pushmana
pushmans	pushmans
puyo	puyo
puyobl	puyobl
puyoj	puyoj
puyoja	puyoja
puyopuy2	puyopuy2
puyosun	puyosun
puzlbang	puzlbang
puzlclub	puzlclub
puzldama	puzldama
puzloopj	puzloopj
puzloopk	puzloopk
puzloopu	puzloopu
puzlstar	puzlstar
puzzldpr	puzzldpr
puzzledp	puzzledp
puzzlekg	puzzlekg
puzzlet	puzzlet
puzzli	puzzli
puzzli2	puzzli2
puzzloop	puzzloop
puzznic	puzznic
puzznici	puzznici
puzznicj	puzznicj
pwheelsj	pwheelsj
pwrgoal	pwrgoal
pwrins2j	pwrins2j
pwrinst2	pwrinst2
pyramid	pyramid
pyros	pyros
pzlbowl	pzlbowl
pzlestar	pzlestar
pzloop2	pzloop2
pzloop2j	pzloop2j
qad	qad
qadj	qadj
qb3	qb3
qbert	qbert
qberta	qberta
qbertjp	qbertjp
qbertqub	qbertqub
qberttst	qberttst
qbtrktst	qbtrktst
qcrayon	qcrayon
qcrayon2	qcrayon2
qdrmfgp	qdrmfgp
qdrmfgp2	qdrmfgp2
qgakumon	qgakumon
qgh	qgh
qix	qix
qix2	qix2
qixa	qixa
qixb	qixb
qjinsei	qjinsei
qmhayaku	qmhayaku
qndream	qndream
qntoond	qntoond
qntoondo	qntoondo
qos	qos
qosa	qosa
qosb	qosb
qrouka	qrouka
qsangoku	qsangoku
qsww	qsww
qtheater	qtheater
qtono1	qtono1
qtono2	qtono2
qtorimon	qtorimon
quantum	quantum
quantum1	quantum1
quantump	quantump
quaquiz2	quaquiz2
quart2	quart2
quart21	quart21
quarterb	quarterb
quartet	quartet
quartet1	quartet1
quarth	quarth
quartrba	quartrba
quasar	quasar
quasara	quasara
quester	quester
quickjac	quickjac
quintond	quintond
quintono	quintono
quintoon	quintoon
quiz	quiz
quiz18k	quiz18k
quiz211	quiz211
quiz365	quiz365
quiz365t	quiz365t
quizchq	quizchq
quizchql	quizchql
quizdai2	quizdai2
quizdais	quizdais
quizdna	quizdna
quizf1	quizf1
quizhq	quizhq
quizhuhu	quizhuhu
quizkof	quizkof
quizmeku	quizmeku
quizmoon	quizmoon
quizmstr	quizmstr
quizo	quizo
quizoa	quizoa
quizpani	quizpani
quizpun2	quizpun2
quiztou	quiztou
quiztvqq	quiztvqq
quizvadr	quizvadr
qwak	qwak
qzchikyu	qzchikyu
qzkklgy2	qzkklgy2
qzkklogy	qzkklogy
qzquest	qzquest
qzshowby	qzshowby
r2dtank	r2dtank
r2dx_v33	r2dx_v33
rabbit	rabbit
rabiolep	rabiolep
raccoon	raccoon
racedcb4	racedcb4
racedcg4	racedcg4
racedrb1	racedrb1
racedrb4	racedrb4
racedrc1	racedrc1
racedrc2	racedrc2
racedrc4	racedrc4
racedrcb	racedrcb
racedrcg	racedrcg
racedrg1	racedrg1
racedrg4	racedrg4
racedriv	racedriv
racedrv1	racedrv1
racedrv2	racedrv2
racedrv3	racedrv3
racedrv4	racedrv4
racedrvb	racedrvb
racedrvc	racedrvc
racedrvg	racedrvg
rachero	rachero
racinfrc	racinfrc
racinfru	racinfru
racingb	racingb
racingj	racingj
racingj2	racingj2
rackemup	rackemup
racknrol	racknrol
radarsc1	radarsc1
radarscp	radarscp
radarzn1	radarzn1
radarznt	radarznt
radarzon	radarzon
radikalb	radikalb
radm	radm
radmu	radmu
radr	radr
radrad	radrad
radru	radru
raf102j	raf102j
raflesia	raflesia
ragnagrd	ragnagrd
ragtime	ragtime
raiden	raiden
raiden2	raiden2
raiden2a	raiden2a
raiden2b	raiden2b
raiden2c	raiden2c
raiden2d	raiden2d
raiden2e	raiden2e
raiden2f	raiden2f
raidena	raidena
raidenk	raidenk
raident	raident
raiders	raiders
raiders5	raiders5
raidndx	raidndx
raidndxj	raidndxj
raidndxm	raidndxm
raidrs5t	raidrs5t
raiga	raiga
raimaijo	raimaijo
raimais	raimais
raimaisj	raimaisj
rainbow	rainbow
rainbowe	rainbowe
rainbowo	rainbowo
rallybik	rallybik
rallys	rallys
rallyx	rallyx
rallyxm	rallyxm
rambo3	rambo3
rambo3a	rambo3a
rambo3ae	rambo3ae
rampage	rampage
rampage2	rampage2
rampart	rampart
rampartj	rampartj
ramprt2p	ramprt2p
raphero	raphero
rastan	rastan
rastanu	rastanu
rastanu2	rastanu2
rastsag1	rastsag1
rastsag2	rastsag2
rastsaga	rastsaga
raveracj	raveracj
raveracw	raveracw
raveraja	raveraja
rayforce	rayforce
rayforcj	rayforcj
raystorj	raystorj
raystorm	raystorm
razmataz	razmataz
rbff1	rbff1
rbff1a	rbff1a
rbff2	rbff2
rbff2h	rbff2h
rbff2k	rbff2k
rbffspec	rbffspec
rbibb	rbibb
rbibba	rbibba
rbmk	rbmk
rbtapper	rbtapper
rcasino	rcasino
rchase	rchase
rchase2	rchase2
rckman2j	rckman2j
rcorsair	rcorsair
rdaction	rdaction
rdft	rdft
rdft2	rdft2
rdft22kc	rdft22kc
rdft2a	rdft2a
rdft2a2	rdft2a2
rdft2j	rdft2j
rdft2t	rdft2t
rdft2us	rdft2us
rdfta	rdfta
rdftau	rdftau
rdftdi	rdftdi
rdftit	rdftit
rdftj	rdftj
rdftu	rdftu
reactor	reactor
reaktor	reaktor
realbrk	realbrk
realbrkj	realbrkj
realbrkk	realbrkk
rebus	rebus
recalh	recalh
recordbr	recordbr
redalert	redalert
redbaron	redbaron
redclash	redclash
redclask	redclask
redclsha	redclsha
redearth	redearth
redeartn	redeartn
redhawk	redhawk
redhawkb	redhawkb
redhawke	redhawke
redhawki	redhawki
redlin2p	redlin2p
redrobin	redrobin
redufo	redufo
reelfun	reelfun
regulus	regulus
reguluso	reguluso
regulusu	regulusu
reikaids	reikaids
relief	relief
relief2	relief2
renaiclb	renaiclb
renegade	renegade
renju	renju
repulse	repulse
rescraid	rescraid
rescrdsa	rescrdsa
rescue	rescue
retofin1	retofin1
retofin2	retofin2
retofinv	retofinv
revenger	revenger
revx	revx
rezon	rezon
rezont	rezont
rf2	rf2
rfjet	rfjet
rfjeta	rfjeta
rfjetj	rfjetj
rfjetu	rfjetu
rfjetus	rfjetus
ribbit	ribbit
ridefgtj	ridefgtj
ridefgtu	ridefgtu
ridger2a	ridger2a
ridger2b	ridger2b
ridgera2	ridgera2
ridgerab	ridgerab
ridgerac	ridgerac
ridgeraj	ridgeraj
ridhero	ridhero
ridheroh	ridheroh
ridingf	ridingf
ridleofp	ridleofp
rimrck12	rimrck12
rimrck16	rimrck16
rimrck20	rimrck20
rimrockn	rimrockn
ringdest	ringdest
ringfgt	ringfgt
ringfgt2	ringfgt2
ringkin2	ringkin2
ringkin3	ringkin3
ringking	ringking
ringkinw	ringkinw
ringohja	ringohja
ringrage	ringrage
ringragj	ringragj
ringragu	ringragu
riot	riot
riotcity	riotcity
ripcord	ripcord
ripoff	ripoff
ripribit	ripribit
riskchal	riskchal
rjammer	rjammer
rmancp2j	rmancp2j
rmhaihai	rmhaihai
rmhaihib	rmhaihib
rmhaijin	rmhaijin
rmhaisei	rmhaisei
rmpgwt	rmpgwt
rmpgwt11	rmpgwt11
roadblc1	roadblc1
roadblcg	roadblcg
roadblg1	roadblg1
roadblg2	roadblg2
roadbls1	roadbls1
roadbls2	roadbls2
roadbls3	roadbls3
roadblsc	roadblsc
roadblsg	roadblsg
roadblst	roadblst
roadburn	roadburn
roadedge	roadedge
roadf	roadf
roadf2	roadf2
roadriot	roadriot
roadrun1	roadrun1
roadrun2	roadrun2
roadrunm	roadrunm
roadrunn	roadrunn
robby	robby
roboarmy	roboarmy
robocop	robocop
robocop2	robocop2
robocopb	robocopb
robocopj	robocopj
robocopu	robocopu
robocopw	robocopw
robocp2j	robocp2j
robocp2u	robocp2u
robocpu0	robocpu0
robokdj2	robokdj2
robokid	robokid
robokidj	robokidj
robotbwl	robotbwl
robotron	robotron
robotryo	robotryo
robowrb	robowrb
robowres	robowres
rockclim	rockclim
rockduck	rockduck
rockmanj	rockmanj
rockn	rockn
rockn2	rockn2
rockn3	rockn3
rockn4	rockn4
rockna	rockna
rocknms	rocknms
rockraga	rockraga
rockrage	rockrage
rockragj	rockragj
rocktris	rocktris
rocktrv2	rocktrv2
rocnrope	rocnrope
rocnropk	rocnropk
rodland	rodland
rodlandj	rodlandj
rodlndjb	rodlndjb
rohga	rohga
rohga1	rohga1
rohga2	rohga2
rohgah	rohgah
rohgau	rohgau
roishtar	roishtar
roldfrga	roldfrga
roldfrog	roldfrog
rollace	rollace
rollace2	rollace2
rollerg	rollerg
rollergj	rollergj
rollingc	rollingc
rompers	rompers
romperso	romperso
rongrngg	rongrngg
rongrngj	rongrngj
rongrong	rongrong
rotaryf	rotaryf
rotd	rotd
roughrac	roughrac
rougien	rougien
roundup	roundup
roundup5	roundup5
route16	route16
route16a	route16a
route16b	route16b
routex	routex
royalcdb	royalcdb
royalcdc	royalcdc
royalcrd	royalcrd
royalmah	royalmah
royalmj	royalmj
rpatrol	rpatrol
rpatrolb	rpatrolb
rpunch	rpunch
rranger	rranger
rrreveng	rrreveng
rrrevenp	rrrevenp
rsgun	rsgun
rshark	rshark
rthun2	rthun2
rthun2j	rthun2j
rthunder	rthunder
rthundro	rthundro
rtriv	rtriv
rtype	rtype
rtype2	rtype2
rtype2j	rtype2j
rtypej	rtypej
rtypejp	rtypejp
rtypelej	rtypelej
rtypeleo	rtypeleo
rtypeu	rtypeu
rugrats	rugrats
runark	runark
runaway	runaway
rundeep	rundeep
rungun	rungun
rungun2	rungun2
runguna	runguna
rungunu	rungunu
rungunua	rungunua
rushatck	rushatck
rushcrsh	rushcrsh
rushhero	rushhero
rvschola	rvschola
rvschool	rvschool
rygar	rygar
rygar2	rygar2
rygar3	rygar3
rygarj	rygarj
ryorioh	ryorioh
ryouran	ryouran
ryujin	ryujin
ryukenda	ryukenda
ryukendn	ryukendn
ryukyu	ryukyu
ryuuha	ryuuha
s1945	s1945
s1945a	s1945a
s1945ii	s1945ii
s1945iii	s1945iii
s1945j	s1945j
s1945jn	s1945jn
s1945k	s1945k
s1945p	s1945p
sabotenb	sabotenb
sabotnba	sabotnba
sadari	sadari
saeuro	saeuro
safari	safari
safarir	safarir
sailormn	sailormn
sailormo	sailormo
sailorwa	sailorwa
sailorwr	sailorwr
sailorws	sailorws
saiyugb1	saiyugb1
saiyugb2	saiyugb2
saiyugou	saiyugou
salamand	salamand
salamanj	salamanj
salarymc	salarymc
salmndr2	salmndr2
saloon	saloon
samba	samba
samesam2	samesam2
samesame	samesame
sams64_2	sams64_2
samsh5sh	samsh5sh
samsh5sn	samsh5sn
samsh5sp	samsh5sp
samsho	samsho
samsho2	samsho2
samsho3	samsho3
samsho4	samsho4
samsho5	samsho5
samsho5b	samsho5b
samsho5h	samsho5h
samshoh	samshoh
samurai	samurai
samuraia	samuraia
sandor	sandor
sandscra	sandscra
sandscrb	sandscrb
sandscrp	sandscrp
sanjeon	sanjeon
sarge	sarge
sarukani	sarukani
sasissu	sasissu
sasuke	sasuke
satansaa	satansaa
satansat	satansat
saturn	saturn
sauro	sauro
savagere	savagere
savgbees	savgbees
sb2003	sb2003
sb2003a	sb2003a
sbagman	sbagman
sbagmans	sbagmans
sbasebal	sbasebal
sbbros	sbbros
sbdk	sbdk
sbishi	sbishi
sbishik	sbishik
sblast2b	sblast2b
sblazerp	sblazerp
sbm	sbm
sboblboa	sboblboa
sboblbob	sboblbob
sbomberb	sbomberb
sbowling	sbowling
sbrkout	sbrkout
sbsgomo	sbsgomo
sbugger	sbugger
sbuggera	sbuggera
scandal	scandal
scandalm	scandalm
scessjoe	scessjoe
scfinals	scfinals
schamp	schamp
schaser	schaser
schasrcv	schasrcv
schmeisr	schmeisr
sci	sci
scia	scia
scij	scij
scion	scion
scionc	scionc
sciu	sciu
scobra	scobra
scobrab	scobrab
scobras	scobras
scobrase	scobrase
scontra	scontra
scontraj	scontraj
scorpion	scorpion
scorpnmc	scorpnmc
scotrsht	scotrsht
scrabble	scrabble
scramb2	scramb2
scramblb	scramblb
scramble	scramble
scrambls	scrambls
scregg	scregg
screwloo	screwloo
scross	scross
scrossu	scrossu
scrpiona	scrpiona
scrpionb	scrpionb
sctionza	sctionza
scud	scud
scuda	scuda
scudhamm	scudhamm
scudp	scudp
sddz	sddz
sderby	sderby
sdfight	sdfight
sdgndmps	sdgndmps
sdgndmrb	sdgndmrb
sdi	sdi
sdib	sdib
sdibl	sdibl
sdmg2	sdmg2
sdodgeb	sdodgeb
sdtennis	sdtennis
sdungeon	sdungeon
sdwx	sdwx
seabass	seabass
searchar	searchar
searchey	searchey
searchp2	searchp2
searthia	searthia
searthin	searthin
seawolf	seawolf
seawolf2	seawolf2
secolove	secolove
secretab	secretab
secretag	secretag
sectionz	sectionz
sectrzon	sectrzon
seganinj	seganinj
seganinu	seganinu
seicross	seicross
seiha	seiha
seiham	seiham
selfeena	selfeena
semibase	semibase
sengekij	sengekij
sengekis	sengekis
sengokh	sengokh
sengokmj	sengokmj
sengoku	sengoku
sengoku2	sengoku2
sengoku3	sengoku3
senjyo	senjyo
senknow	senknow
senkyu	senkyu
senkyua	senkyua
sentetst	sentetst
sercharj	sercharj
sercharu	sercharu
sextriv	sextriv
sextriv1	sextriv1
sextriv2	sextriv2
sexyboom	sexyboom
sexyparo	sexyparo
sf	sf
sf2	sf2
sf2049	sf2049
sf2049se	sf2049se
sf2049te	sf2049te
sf2accp2	sf2accp2
sf2ce	sf2ce
sf2cej	sf2cej
sf2ceua	sf2ceua
sf2ceub	sf2ceub
sf2ceuc	sf2ceuc
sf2eb	sf2eb
sf2hf	sf2hf
sf2j	sf2j
sf2ja	sf2ja
sf2jc	sf2jc
sf2koryu	sf2koryu
sf2m1	sf2m1
sf2m2	sf2m2
sf2m3	sf2m3
sf2m4	sf2m4
sf2m5	sf2m5
sf2m6	sf2m6
sf2m7	sf2m7
sf2mdt	sf2mdt
sf2rb	sf2rb
sf2rb2	sf2rb2
sf2red	sf2red
sf2t	sf2t
sf2tj	sf2tj
sf2ua	sf2ua
sf2ub	sf2ub
sf2ud	sf2ud
sf2ue	sf2ue
sf2uf	sf2uf
sf2ui	sf2ui
sf2uk	sf2uk
sf2v004	sf2v004
sf2yyc	sf2yyc
sfa	sfa
sfa2	sfa2
sfa2u	sfa2u
sfa3	sfa3
sfa3b	sfa3b
sfa3u	sfa3u
sfa3ur1	sfa3ur1
sfar1	sfar1
sfar2	sfar2
sfar3	sfar3
sfau	sfau
sfchamp	sfchamp
sfchampj	sfchampj
sfex	sfex
sfex2	sfex2
sfex2a	sfex2a
sfex2j	sfex2j
sfex2p	sfex2p
sfex2pa	sfex2pa
sfex2pj	sfex2pj
sfexa	sfexa
sfexj	sfexj
sfexp	sfexp
sfexpj	sfexpj
sfexpu1	sfexpu1
sfexu	sfexu
sfiii	sfiii
sfiii2	sfiii2
sfiii2n	sfiii2n
sfiii2u	sfiii2u
sfiii3	sfiii3
sfiii3a	sfiii3a
sfiii3an	sfiii3an
sfiii3n	sfiii3n
sfiiin	sfiiin
sfiiiu	sfiiiu
sfish2	sfish2
sfish2j	sfish2j
sfjp	sfjp
sfkick	sfkick
sflush	sflush
sfootbal	sfootbal
sformula	sformula
sfp	sfp
sfposeid	sfposeid
sfrush	sfrush
sfrushrk	sfrushrk
sftm	sftm
sftm110	sftm110
sftm111	sftm111
sftmj	sftmj
sfus	sfus
sfx	sfx
sfz2a	sfz2a
sfz2aa	sfz2aa
sfz2ab	sfz2ab
sfz2ah	sfz2ah
sfz2aj	sfz2aj
sfz2b	sfz2b
sfz2br1	sfz2br1
sfz2h	sfz2h
sfz2j	sfz2j
sfz2n	sfz2n
sfz3a	sfz3a
sfz3ar1	sfz3ar1
sfz3j	sfz3j
sfz3jr1	sfz3jr1
sfz3jr2	sfz3jr2
sfz3ugd	sfz3ugd
sfza	sfza
sfzb	sfzb
sfzbr1	sfzbr1
sfzh	sfzh
sfzj	sfzj
sfzjr1	sfzjr1
sfzjr2	sfzjr2
sgemf	sgemf
sgemfa	sgemfa
sgemfh	sgemfh
sgladiat	sgladiat
sgmast	sgmast
sgmastc	sgmastc
sgmastj	sgmastj
sgt24h	sgt24h
sgunner	sgunner
sgunner2	sgunner2
sgunnerj	sgunnerj
sgunnr2j	sgunnr2j
shackled	shackled
shadfgtr	shadfgtr
shadfrce	shadfrce
shadfrcj	shadfrcj
shadowld	shadowld
shadoww	shadoww
shadowwa	shadowwa
shangha2	shangha2
shangha3	shangha3
shanghai	shanghai
shangkid	shangkid
shangnle	shangnle
shangon	shangon
shangon1	shangon1
shangon2	shangon2
shangon3	shangon3
shangupb	shangupb
shanhigw	shanhigw
shaolins	shaolins
sharkatt	sharkatt
sharkpy	sharkpy
sharkpya	sharkpya
sharrier	sharrier
sharrir1	sharrir1
shdancbl	shdancbl
shdance1	shdance1
shdancej	shdancej
shdancer	shdancer
sheriff	sheriff
shienryu	shienryu
shimpacp	shimpacp
shimpact	shimpact
shimpap4	shimpap4
shinobi	shinobi
shinobi1	shinobi1
shinobi2	shinobi2
shinobi3	shinobi3
shinobi4	shinobi4
shinobi5	shinobi5
shinoblb	shinoblb
shinobld	shinobld
shinobls	shinobls
shippumd	shippumd
shiryu2	shiryu2
shisen	shisen
shisen2	shisen2
shngmtkb	shngmtkb
shocking	shocking
shocktr2	shocktr2
shocktra	shocktra
shocktro	shocktro
shogware	shogware
shogwarr	shogwarr
shollow	shollow
shollow2	shollow2
shootbul	shootbul
shootgal	shootgal
shootoub	shootoub
shootouj	shootouj
shootout	shootout
shougi	shougi
shougi2	shougi2
showdown	showdown
showhand	showhand
shpeng	shpeng
shrike	shrike
shtngms1	shtngms1
shtngmsa	shtngmsa
shtngmst	shtngmst
shtrider	shtrider
shtridra	shtridra
shuffle	shuffle
shufshot	shufshot
shuttlei	shuttlei
shuuz	shuuz
shuuz2	shuuz2
sia2650	sia2650
sichuan2	sichuan2
sichuana	sichuana
sicv	sicv
sidearjp	sidearjp
sidearmr	sidearmr
sidearms	sidearms
sidebs	sidebs
sidebs2	sidebs2
sidebs2j	sidebs2j
sidepckt	sidepckt
sidepctb	sidepctb
sidepctj	sidepctj
sidetrac	sidetrac
sidewndr	sidewndr
sigma2k	sigma2k
sigmapkr	sigmapkr
silentd	silentd
silentdj	silentdj
silentdu	silentdu
silkroad	silkroad
silkworm	silkworm
silkwrm2	silkwrm2
silvland	silvland
simp2pa	simp2pa
simpbowl	simpbowl
simps2pa	simps2pa
simps2pj	simps2pj
simps4pa	simps4pa
simpsn2p	simpsn2p
simpsons	simpsons
sindbadm	sindbadm
sinista1	sinista1
sinista2	sinista2
sinistar	sinistar
sinvasn	sinvasn
sinvasnb	sinvasnb
sinvemag	sinvemag
sinvzen	sinvzen
sisv	sisv
sisv2	sisv2
sitv	sitv
sjcd2kx3	sjcd2kx3
sjryuko	sjryuko
sjryuko1	sjryuko1
skattv	skattv
skattva	skattva
skelagon	skelagon
skichamp	skichamp
skiltrek	skiltrek
skingam2	skingam2
skingame	skingame
skisuprg	skisuprg
skns	skns
skullfng	skullfng
skullxb1	skullxb1
skullxb2	skullxb2
skullxb3	skullxb3
skullxb4	skullxb4
skullxbo	skullxbo
skyadvnj	skyadvnj
skyadvnt	skyadvnt
skyadvnu	skyadvnu
skyalert	skyalert
skyarmy	skyarmy
skybase	skybase
skybump	skybump
skychut	skychut
skydiver	skydiver
skyfox	skyfox
skykid	skykid
skykidd	skykidd
skykiddo	skykiddo
skykiddx	skykiddx
skykido	skykido
skykids	skykids
skylance	skylance
skylancr	skylancr
skylncr	skylncr
skyraid	skyraid
skyraidr	skyraidr
skyrobo	skyrobo
skyshark	skyshark
skyskipr	skyskipr
skysmash	skysmash
skysoldr	skysoldr
skytargt	skytargt
skywolf	skywolf
skywolf2	skywolf2
slamdnk2	slamdnk2
slammast	slammast
slammasu	slammasu
slapbtjp	slapbtjp
slapbtuk	slapbtuk
slapfgtr	slapfgtr
slapfiga	slapfiga
slapfigh	slapfigh
slapshot	slapshot
slasho	slasho
sliksh16	sliksh16
sliksh17	sliksh17
slikshot	slikshot
slipstrh	slipstrh
slipstrm	slipstrm
slither	slither
slithera	slithera
sliver	sliver
slmdunkj	slmdunkj
slotsnl	slotsnl
slqz2	slqz2
slrasslt	slrasslt
sltblgp1	sltblgp1
sltblgpo	sltblgpo
sltblgtk	sltblgtk
slyspy	slyspy
slyspy2	slyspy2
smarinef	smarinef
smashtv	smashtv
smashtv4	smashtv4
smashtv5	smashtv5
smashtv6	smashtv6
smbomb	smbomb
smbombr1	smbombr1
smgolf	smgolf
smgolfb	smgolfb
smgolfj	smgolfj
smgp	smgp
smgp5	smgp5
smgp6	smgp6
smgpj	smgpj
smgpja	smgpja
smgpu	smgpu
smgpu1	smgpu1
smgpu2	smgpu2
smgpu3	smgpu3
smleague	smleague
smooncrs	smooncrs
smoto16	smoto16
smoto20	smoto20
smstrv	smstrv
snakepit	snakepit
snakjack	snakjack
snapjack	snapjack
snapper	snapper
sncwgltd	sncwgltd
sngkace	sngkace
snookr10	snookr10
snowbalt	snowbalt
snowboar	snowboar
snowbro2	snowbro2
snowbro3	snowbro3
snowbroa	snowbroa
snowbrob	snowbrob
snowbroc	snowbroc
snowbrod	snowbrod
snowbroj	snowbroj
snowbros	snowbros
socbrala	socbrala
socbrawl	socbrawl
soccer	soccer
soccernw	soccernw
soccersa	soccersa
soccersj	soccersj
soccerss	soccerss
sogeki	sogeki
sokonuke	sokonuke
sokyugrt	sokyugrt
solarfox	solarfox
solarq	solarq
solarwar	solarwar
soldamj	soldamj
soldivid	soldivid
solfight	solfight
solfigtr	solfigtr
solomon	solomon
solomonj	solomonj
solvalou	solvalou
sonic	sonic
sonicbom	sonicbom
sonicp	sonicp
sonicwi	sonicwi
sonicwi2	sonicwi2
sonicwi3	sonicwi3
sonofphx	sonofphx
sonson	sonson
sonsonj	sonsonj
sos	sos
sosterm	sosterm
sotsugyo	sotsugyo
soukobdx	soukobdx
soulclba	soulclba
soulclbb	soulclbb
soulclbc	soulclbc
soulclbd	soulclbd
soulclbr	soulclbr
souledga	souledga
souledgb	souledgb
souledgc	souledgc
souledge	souledge
spacbat2	spacbat2
spacbatt	spacbatt
spacbeam	spacbeam
spacduel	spacduel
spaceaa	spaceaa
spaceaa2	spaceaa2
spaceace	spaceace
spaceat2	spaceat2
spaceatt	spaceatt
spacebrd	spacebrd
spacecho	spacecho
spacecr	spacecr
spacedem	spacedem
spacedx	spacedx
spacedxj	spacedxj
spacedxo	spacedxo
spacefb	spacefb
spacefbb	spacefbb
spacefbg	spacefbg
spacefev	spacefev
spacefrt	spacefrt
spaceftr	spaceftr
spacefva	spacefva
spaceg	spaceg
spacegun	spacegun
spaceinj	spaceinj
spaceint	spaceint
spacelnc	spacelnc
spaceod	spaceod
spaceod2	spaceod2
spaceph	spaceph
spacepir	spacepir
spaceplt	spaceplt
spaceskr	spaceskr
spacetrk	spacetrk
spacewar	spacewar
spacewr3	spacewr3
spacezap	spacezap
spacfura	spacfura
spacfurb	spacfurb
spacfury	spacfury
spang	spang
spangbl	spangbl
spangj	spangj
sparkman	sparkman
sparkz	sparkz
spartanx	spartanx
spatter	spatter
spawn	spawn
spbactn	spbactn
spbactnj	spbactnj
spcdrag	spcdrag
spcdraga	spcdraga
spceking	spceking
spcenctr	spcenctr
spcewarl	spcewarl
spcewars	spcewars
spcforc2	spcforc2
spcforce	spcforce
spcfrcii	spcfrcii
spcinv95	spcinv95
spcinvdj	spcinvdj
spcking2	spcking2
spclaser	spclaser
spclforc	spclforc
spclorda	spclorda
spclordb	spclordb
spclordg	spclordg
spclords	spclords
spcnv95u	spcnv95u
spcpostn	spcpostn
spctbird	spctbird
spdball	spdball
spdcoin	spdcoin
spdodgeb	spdodgeb
speakres	speakres
spec2k	spec2k
spectar	spectar
spectar1	spectar1
speedatk	speedatk
speedbal	speedbal
speedfrk	speedfrk
speedrcr	speedrcr
speedspn	speedspn
speedup	speedup
speglsht	speglsht
spellbnd	spellbnd
spelnkrj	spelnkrj
spelunk2	spelunk2
spelunkr	spelunkr
spf2t	spf2t
spf2ta	spf2ta
spf2xj	spf2xj
spfghmk2	spfghmk2
spfgmk22	spfgmk22
spiders	spiders
spiders2	spiders2
spidman	spidman
spidmanu	spidmanu
spiero	spiero
spikeofe	spikeofe
spikeout	spikeout
spiker	spiker
spikes91	spikes91
spinkick	spinkick
spinlbrj	spinlbrj
spinlbrk	spinlbrk
spinlbru	spinlbru
spinmast	spinmast
spinner	spinner
spitboss	spitboss
splash	splash
splash10	splash10
splat	splat
splattej	splattej
splatter	splatter
splndrbt	splndrbt
spnchotj	spnchotj
spnchout	spnchout
spool3	spool3
spool3i	spool3i
spotty	spotty
sprcros2	sprcros2
sprcrs2a	sprcrs2a
sprglbpg	sprglbpg
sprglobp	sprglobp
springer	springer
sprint1	sprint1
sprint2	sprint2
sprint2a	sprint2a
sprint4	sprint4
sprint4a	sprint4a
sprint8	sprint8
sprint8a	sprint8a
sprmatkd	sprmatkd
sprtmtch	sprtmtch
sptrekct	sptrekct
spy	spy
spyhnt2a	spyhnt2a
spyhunt	spyhunt
spyhunt2	spyhunt2
spyhuntp	spyhuntp
spyu	spyu
sqbert	sqbert
sqix	sqix
sqixa	sqixa
sqixbl	sqixbl
sqixu	sqixu
squaitsa	squaitsa
squash	squash
sraider	sraider
srally2	srally2
srallyc	srallyc
sraly2dx	sraly2dx
sranger	sranger
srangerb	srangerb
srangerw	srangerw
srdarwin	srdarwin
srdarwnj	srdarwnj
srdmissn	srdmissn
srmp1	srmp1
srmp2	srmp2
srmp3	srmp3
srmp4	srmp4
srmp4o	srmp4o
srmp5	srmp5
srmp6	srmp6
srmp7	srmp7
srmvs	srmvs
srumbler	srumbler
srumblr2	srumblr2
ssanchan	ssanchan
sscandal	sscandal
sscope	sscope
sscope2	sscope2
sscopea	sscopea
sscopex	sscopex
ssf2	ssf2
ssf2a	ssf2a
ssf2ar1	ssf2ar1
ssf2ghw	ssf2ghw
ssf2j	ssf2j
ssf2jr1	ssf2jr1
ssf2jr2	ssf2jr2
ssf2t	ssf2t
ssf2ta	ssf2ta
ssf2tb	ssf2tb
ssf2tbj	ssf2tbj
ssf2tbr1	ssf2tbr1
ssf2tu	ssf2tu
ssf2tur1	ssf2tur1
ssf2u	ssf2u
ssf2xj	ssf2xj
ssfindo	ssfindo
sshangha	sshangha
sshanghb	sshanghb
sshoot11	sshoot11
sshoot12	sshoot12
sshooter	sshooter
sshot137	sshot137
sshot139	sshot139
ssi	ssi
ssideki	ssideki
ssideki2	ssideki2
ssideki3	ssideki3
ssideki4	ssideki4
ssingles	ssingles
ssipkr24	ssipkr24
ssipkr30	ssipkr30
ssipkr40	ssipkr40
sslam	sslam
sslama	sslama
ssmissin	ssmissin
ssoldier	ssoldier
ssozumo	ssozumo
sspac2k1	sspac2k1
sspacaho	sspacaho
sspacat2	sspacat2
sspacat3	sspacat3
sspacatc	sspacatc
sspaceat	sspaceat
sspeedr	sspeedr
sspiritj	sspiritj
sspirits	sspirits
sspirtfc	sspirtfc
sspring1	sspring1
ssprint	ssprint
ssprint1	ssprint1
ssprint3	ssprint3
ssprintf	ssprintf
ssprintg	ssprintg
ssprints	ssprints
ssrdrabd	ssrdrabd
ssrdradd	ssrdradd
ssrdreaa	ssrdreaa
ssrdrebc	ssrdrebc
ssrdrebd	ssrdrebd
ssrdrjbd	ssrdrjbd
ssrdruac	ssrdruac
ssrdrubc	ssrdrubc
ssrdruda	ssrdruda
ssriders	ssriders
ssrj	ssrj
sss	sss
sstarbtl	sstarbtl
sstingry	sstingry
sstrangr	sstrangr
sstrike	sstrike
sstriker	sstriker
sstrikra	sstrikra
sstrngr2	sstrngr2
stactics	stactics
stadh96a	stadh96a
stadhero	stadhero
stadhr96	stadhr96
stagger1	stagger1
stakwin	stakwin
stakwin2	stakwin2
stankatk	stankatk
starblad	starblad
starcas	starcas
starcas1	starcas1
starcase	starcase
starcasp	starcasp
starcrus	starcrus
starfght	starfght
starfigh	starfigh
starfir2	starfir2
starfira	starfira
starfire	starfire
starfora	starfora
starforb	starforb
starforc	starforc
starfore	starfore
stargate	stargate
starglad	starglad
stargld2	stargld2
stargrds	stargrds
starhawk	starhawk
starjack	starjack
starjacs	starjacs
starlstr	starlstr
starshp1	starshp1
starshpp	starshpp
starsldr	starsldr
starspnr	starspnr
starswep	starswep
startrek	startrek
startrgn	startrgn
startrkd	startrkd
starw	starw
starwar1	starwar1
starwars	starwars
statriv2	statriv2
statriv4	statriv4
stcc	stcc
stdragon	stdragon
steaser	steaser
steelta1	steelta1
steeltag	steeltag
steeltal	steeltal
steeltap	steeltap
stellcas	stellcas
stellecu	stellecu
stepstag	stepstag
stfight	stfight
stfighta	stfighta
stg	stg
stinger	stinger
stinger2	stinger2
stkclmnj	stkclmnj
stkclmns	stkclmns
stlforce	stlforce
stmblade	stmblade
stocker	stocker
stoffy	stoffy
stompin	stompin
stoneage	stoneage
stoneba2	stoneba2
stonebal	stonebal
storming	storming
strahl	strahl
strahla	strahla
stratab	stratab
stratab1	stratab1
stratgys	stratgys
stratgyx	stratgyx
stratof	stratof
stratvob	stratvob
stratvox	stratvox
streakng	streakng
streets1	streets1
streetsj	streetsj
streetsm	streetsm
streetsw	streetsw
stress	stress
strfbomb	strfbomb
strhoop	strhoop
strider	strider
strider2	strider2
striderj	striderj
stridr2a	stridr2a
stridrja	stridrja
stridrua	stridrua
striv	striv
strkfgtr	strkfgtr
strkforc	strkforc
strkzone	strkzone
strnskil	strnskil
strtdriv	strtdriv
strtheat	strtheat
strvmstr	strvmstr
stunrn2e	stunrn2e
stunrn3e	stunrn3e
stunrun	stunrun
stunrun0	stunrun0
stunrun2	stunrun2
stunrun3	stunrun3
stunrun4	stunrun4
stunrun5	stunrun5
stunrune	stunrune
stunrunj	stunrunj
stunrunp	stunrunp
stvbios	stvbios
subhunt	subhunt
subroc3d	subroc3d
subs	subs
sucasino	sucasino
suchie3	suchie3
suchipi	suchipi
suikoenb	suikoenb
sunaq	sunaq
sundance	sundance
sunsetbl	sunsetbl
supbtima	supbtima
supbtime	supbtime
supbtimj	supbtimj
supcrash	supcrash
supdrapo	supdrapo
superbik	superbik
superbon	superbon
superbug	superbug
superbwl	superbwl
superchs	superchs
superdq	superdq
superdqa	superdqa
superdqs	superdqs
superg	superg
supergx	supergx
superinv	superinv
superman	superman
superpac	superpac
superpcm	superpcm
superspy	superspy
supertnk	supertnk
supertr2	supertr2
supertr3	supertr3
superx	superx
superxm	superxm
suplup	suplup
supmodel	supmodel
supnudg2	supnudg2
suprglob	suprglob
suprgolf	suprgolf
suprleag	suprleag
suprloco	suprloco
suprmanj	suprmanj
suprmatk	suprmatk
suprmous	suprmous
suprmria	suprmria
suprmrio	suprmrio
suprpool	suprpool
suprridr	suprridr
suprslam	suprslam
suprtrio	suprtrio
supxevs	supxevs
suratk	suratk
suratka	suratka
suratkj	suratkj
surfplnt	surfplnt
survarts	survarts
survartu	survartu
survival	survival
susume	susume
sutapper	sutapper
suzuk8h2	suzuk8h2
suzuk8hj	suzuk8hj
suzuka8h	suzuka8h
suzume	suzume
svc	svc
svcboot	svcboot
svcpcb	svcpcb
svcpcba	svcpcba
svcplus	svcplus
svcplusa	svcplusa
svcsplus	svcsplus
svf	svf
svolley	svolley
svolleyk	svolleyk
svolleyu	svolleyu
svolly91	svolly91
svs	svs
swa	swa
swarm	swarm
swat	swat
swatpolc	swatpolc
swcourt	swcourt
swcourtj	swcourtj
swimmer	swimmer
swimmera	swimmera
swimmerb	swimmerb
sws	sws
sws2000	sws2000
sws2001	sws2001
sws92	sws92
sws92g	sws92g
sws93	sws93
sws95	sws95
sws96	sws96
sws97	sws97
sws98	sws98
sws99	sws99
swtrilga	swtrilga
swtrilgy	swtrilgy
sxevious	sxevious
sxyreac2	sxyreac2
sxyreact	sxyreact
sys573	sys573
syvalion	syvalion
szaxxon	szaxxon
tacscan	tacscan
tactcan2	tactcan2
tactcian	tactcian
tagteam	tagteam
tail2nos	tail2nos
tailg	tailg
taitofx1	taitofx1
taitogn	taitogn
taiwanmb	taiwanmb
talbot	talbot
tangtang	tangtang
tank8	tank8
tank8a	tank8a
tank8b	tank8b
tank8c	tank8c
tank8d	tank8d
tankbatt	tankbatt
tankbust	tankbust
tankfrc4	tankfrc4
tankfrce	tankfrce
tankfrcj	tankfrcj
tantr	tantr
tantrbl	tantrbl
tantrbl2	tantrbl2
tantrbl3	tantrbl3
tantrkor	tantrkor
taotaida	taotaida
taotaido	taotaido
tapper	tapper
tappera	tappera
targ	targ
targc	targc
targeth	targeth
tarzan	tarzan
tattack	tattack
tattass	tattass
tattassa	tattassa
taxidrvr	taxidrvr
tazmani2	tazmani2
tazmania	tazmania
tazzmang	tazzmang
tblkkuzu	tblkkuzu
tbowl	tbowl
tbowlj	tbowlj
tbyahhoo	tbyahhoo
tceptor	tceptor
tceptor2	tceptor2
tcl	tcl
tcobra2	tcobra2
tcobra2u	tcobra2u
tdfever	tdfever
tdfever2	tdfever2
tdfeverj	tdfeverj
tdragn2a	tdragn2a
tdragon	tdragon
tdragon1	tdragon1
tdragon2	tdragon2
tdragonb	tdragonb
te0144	te0144
teamqb	teamqb
teamqb2	teamqb2
techromn	techromn
techromu	techromu
tecmowcm	tecmowcm
teddybb	teddybb
teddybbo	teddybbo
teedoff	teedoff
teetert	teetert
tehkanwb	tehkanwb
tehkanwc	tehkanwc
tekipaki	tekipaki
tekken	tekken
tekken2	tekken2
tekken2a	tekken2a
tekken2b	tekken2b
tekken3	tekken3
tekken3a	tekken3a
tekken3b	tekken3b
tekken3c	tekken3c
tekkena	tekkena
tekkenb	tekkenb
tekkenc	tekkenc
tektagt	tektagt
tektagta	tektagta
tektagtb	tektagtb
tektagtc	tektagtc
teljan	teljan
telmahjn	telmahjn
tempest	tempest
tempest1	tempest1
tempest2	tempest2
tempest3	tempest3
temptube	temptube
tenballs	tenballs
tenkai	tenkai
tenkai2b	tenkai2b
tenkaibb	tenkaibb
tenkaicb	tenkaicb
tenkaid	tenkaid
tenkaie	tenkaie
tenkomoj	tenkomoj
tenkomor	tenkomor
tenpindx	tenpindx
tenthdeg	tenthdeg
tenup	tenup
tenup3	tenup3
teplus2j	teplus2j
terabrst	terabrst
term2	term2
term2la1	term2la1
term2la2	term2la2
terracra	terracra
terracrb	terracrb
terracre	terracre
terraf	terraf
terrafa	terrafa
terrafb	terrafb
terrafu	terrafu
tetris	tetris
tetris1	tetris1
tetris2	tetris2
tetris3	tetris3
tetrisbl	tetrisbl
tetrisp	tetrisp
tetrisp2	tetrisp2
tetrisse	tetrisse
tetrist	tetrist
tetrista	tetrista
tetriunk	tetriunk
tetrsark	tetrsark
tfrceac	tfrceac
tfrceacb	tfrceacb
tfrceacj	tfrceacj
tgmj	tgmj
tgtball	tgtball
tgtballa	tgtballa
tharierj	tharierj
tharrier	tharrier
thayers	thayers
thayersa	thayersa
thedeep	thedeep
theend	theend
theends	theends
theglad	theglad
theglob	theglob
theglob2	theglob2
theglob3	theglob3
theglobp	theglobp
thegrid	thegrid
thegrida	thegrida
thehand	thehand
thehustj	thehustj
thehustl	thehustl
themj	themj
thepit	thepit
thepitb	thepitb
thepitc	thepitc
theroes	theroes
thetogyu	thetogyu
thief	thief
thndblst	thndblst
thnderxa	thnderxa
thnderxb	thnderxb
thnderxj	thnderxj
thndfoxj	thndfoxj
thndfoxu	thndfoxu
thndrbd1	thndrbd1
thndrbld	thndrbld
thndrx2	thndrx2
thndrx2a	thndrx2a
thndzone	thndzone
thoop	thoop
thoop2	thoop2
thrild2	thrild2
thrild2a	thrild2a
thrilld	thrilld
thunderh	thunderh
thunderj	thunderj
thunderl	thunderl
thunderx	thunderx
thundfox	thundfox
thunt	thunt
thuntk	thuntk
tickee	tickee
tictac	tictac
tigerh	tigerh
tigerhb1	tigerhb1
tigerhb2	tigerhb2
tigerhb3	tigerhb3
tigerhj	tigerhj
tigeroad	tigeroad
tigerodb	tigerodb
timber	timber
timecris	timecris
timecrs2	timecrs2
timecrsa	timecrsa
timek131	timek131
timekill	timekill
timelimt	timelimt
timemchn	timemchn
timeplt	timeplt
timeplta	timeplta
timepltc	timepltc
timesca1	timesca1
timescan	timescan
timesol1	timesol1
timesold	timesold
timetunl	timetunl
tinklpit	tinklpit
tinstar	tinstar
tinstar2	tinstar2
tinv2650	tinv2650
tiptop	tiptop
titlef	titlef
titlefu	titlefu
tjsb	tjsb
tkdensha	tkdensha
tkdensho	tkdensho
tkmmpzdm	tkmmpzdm
tknight	tknight
tkoboxng	tkoboxng
tm	tm
tm3k	tm3k
tm3ka	tm3ka
tm4k	tm4k
tm5k	tm5k
tm7k	tm7k
tm7ka	tm7ka
tm8k	tm8k
tmek	tmek
tmekprot	tmekprot
tmht	tmht
tmht22pe	tmht22pe
tmht2p	tmht2p
tmht2pa	tmht2pa
tmmjprd	tmmjprd
tmnt	tmnt
tmnt2	tmnt2
tmnt22pu	tmnt22pu
tmnt2a	tmnt2a
tmnt2pj	tmnt2pj
tmnt2po	tmnt2po
tmntj	tmntj
tmntu	tmntu
tmntua	tmntua
tndrcade	tndrcade
tndrcadj	tndrcadj
tnexspce	tnexspce
tnk3	tnk3
tnk3j	tnk3j
tnzs	tnzs
tnzsj	tnzsj
tnzso	tnzso
todruaga	todruaga
todruago	todruago
toffy	toffy
toggle	toggle
toki	toki
tokia	tokia
tokib	tokib
tokimbsj	tokimbsj
tokimosh	tokimosh
tokimosp	tokimosp
tokio	tokio
tokiob	tokiob
tokiou	tokiou
tokisens	tokisens
tokiu	tokiu
tokkae	tokkae
tokyogal	tokyogal
tomahaw1	tomahaw1
tomahawk	tomahawk
tomcatsw	tomcatsw
tondemo	tondemo
tontonb	tontonb
toobin	toobin
toobin1	toobin1
toobin2	toobin2
toobin2e	toobin2e
toobine	toobine
toobing	toobing
topbladv	topbladv
topgun	topgun
topgunbl	topgunbl
topgunnr	topgunnr
topgunr	topgunr
tophunta	tophunta
tophuntr	tophuntr
topland	topland
toppyrap	toppyrap
topracer	topracer
topracra	topracra
topracrb	topracrb
toprollr	toprollr
topsecex	topsecex
topsecrt	topsecrt
topshoot	topshoot
topskatr	topskatr
topspedu	topspedu
topspeed	topspeed
toramich	toramich
toratora	toratora
torid2gg	torid2gg
toride2g	toride2g
toride2j	toride2j
tornado1	tornado1
tornado2	tornado2
tornbase	tornbase
tortufam	tortufam
torus	torus
toryumon	toryumon
totcarn	totcarn
totcarnp	totcarnp
totlvice	totlvice
totmejan	totmejan
touchgo	touchgo
touchgoe	touchgoe
touchgon	touchgon
toukon3	toukon3
tourtab2	tourtab2
tourtabl	tourtabl
toutrun	toutrun
toutrun1	toutrun1
toutrun2	toutrun2
toutrunu	toutrunu
toyfight	toyfight
toypop	toypop
tp2m32	tp2m32
tp84	tp84
tp84a	tp84a
tp84b	tp84b
tpgolf	tpgolf
tps	tps
trackflc	trackflc
trackfld	trackfld
trailblz	trailblz
trally	trally
tranqgun	tranqgun
transfrm	transfrm
travrusa	travrusa
trckydca	trckydca
trckydoc	trckydoc
treahunt	treahunt
trebltop	trebltop
tricktrp	tricktrp
trigon	trigon
triothej	triothej
triothep	triothep
triplep	triplep
triplew1	triplew1
triplew2	triplew2
triplfun	triplfun
triplhnt	triplhnt
tripool	tripool
tripoola	tripoola
trisport	trisport
trivia12	trivia12
triviabb	triviabb
triviaes	triviaes
triviag1	triviag1
triviag2	triviag2
trivialp	trivialp
triviasp	triviasp
triviayp	triviayp
trivquiz	trivquiz
troangel	troangel
trog	trog
trog3	trog3
trog4	trog4
trogp	trogp
trogpa6	trogpa6
trojan	trojan
trojanj	trojanj
trojanr	trojanr
tron	tron
tron2	tron2
tron3	tron3
tron4	tron4
trophyh	trophyh
trstar	trstar
trstarj	trstarj
trstaro	trstaro
trstaroj	trstaroj
truco	truco
trucocl	trucocl
truxton	truxton
truxton2	truxton2
trvchlng	trvchlng
trvgns	trvgns
trvmadns	trvmadns
trvmstr	trvmstr
trvmstra	trvmstra
trvmstrb	trvmstrb
trvquest	trvquest
trvwz2	trvwz2
trvwz3h	trvwz3h
trvwz3v	trvwz3v
trvwz4	trvwz4
trvwzh	trvwzh
trvwzha	trvwzha
trvwzv	trvwzv
trvwzva	trvwzva
tryout	tryout
ts2	ts2
ts2j	ts2j
tsamura2	tsamura2
tsamurai	tsamurai
tshingen	tshingen
tshingna	tshingna
tshoot	tshoot
tst_galx	tst_galx
tst_invd	tst_invd
tstrike	tstrike
tstrikea	tstrikea
tsurugi	tsurugi
tsurugij	tsurugij
ttchamp	ttchamp
ttchampa	ttchampa
ttmahjng	ttmahjng
tturf	tturf
tturfbl	tturfbl
tturfu	tturfu
tubeit	tubeit
tubep	tubep
tubepb	tubepb
tugboat	tugboat
tumbleb	tumbleb
tumbleb2	tumbleb2
tumblep	tumblep
tumblepj	tumblepj
tunhunt	tunhunt
tunhuntc	tunhuntc
turbo	turbo
turboa	turboa
turbob	turbob
turbofrc	turbofrc
turbosub	turbosub
turbotag	turbotag
turfmast	turfmast
turkhunt	turkhunt
turnover	turnover
turpin	turpin
turpins	turpins
turtles	turtles
turtshij	turtshij
turtshik	turtshik
turtship	turtship
tutankhm	tutankhm
tutankst	tutankst
tutstomb	tutstomb
twcup98	twcup98
twinactn	twinactn
twinadv	twinadv
twinadvk	twinadvk
twinbee	twinbee
twinbrat	twinbrat
twinbrta	twinbrta
twincobr	twincobr
twincobu	twincobu
twineag2	twineag2
twineagl	twineagl
twinfalc	twinfalc
twinhawk	twinhawk
twinhwku	twinhwku
twinkle	twinkle
twinqix	twinqix
twins	twins
twinsa	twinsa
twinspri	twinspri
twinsqua	twinsqua
twocrude	twocrude
twotiger	twotiger
twotigrc	twotigrc
twrdc94a	twrdc94a
twrldc94	twrldc94
twrshaft	twrshaft
tws96	tws96
tx1	tx1
tx1a	tx1a
tylz	tylz
typhoon	typhoon
uballoon	uballoon
uccops	uccops
uccopsar	uccopsar
uccopsj	uccopsj
uchuuai	uchuuai
uecology	uecology
ufosensb	ufosensb
ufosensi	ufosensi
ultennis	ultennis
ultraman	ultraman
ultramhm	ultramhm
ultratnk	ultratnk
ultrax	ultrax
umanclub	umanclub
umk3	umk3
umk3r10	umk3r10
umk3r11	umk3r11
undoukai	undoukai
undrfire	undrfire
undrfirj	undrfirj
undrfiru	undrfiru
uniwars	uniwars
unsquad	unsquad
untoucha	untoucha
uopoko	uopoko
uopokoj	uopokoj
upndown	upndown
upndownu	upndownu
upscope	upscope
upyoural	upyoural
urashima	urashima
usclssic	usclssic
usg182	usg182
usg185	usg185
usg252	usg252
usg32	usg32
usg82	usg82
usg83	usg83
usg83x	usg83x
usvsthem	usvsthem
utoukond	utoukond
valkyrie	valkyrie
valtric	valtric
vamphalf	vamphalf
vampj	vampj
vampja	vampja
vampjr1	vampjr1
vandyja2	vandyja2
vandyjal	vandyjal
vandyke	vandyke
vandykeb	vandykeb
vangrd2	vangrd2
vangrdce	vangrdce
vanguard	vanguard
vanguarj	vanguarj
vanilla	vanilla
vanvan	vanvan
vanvanb	vanvanb
vanvank	vanvank
vaportra	vaportra
vaportrp	vaportrp
vaportru	vaportru
vaportrx	vaportrx
varth	varth
varthj	varthj
varthr1	varthr1
varthu	varthu
vasara	vasara
vasara2	vasara2
vasara2a	vasara2a
vastar	vastar
vastar2	vastar2
vautour	vautour
vautourz	vautourz
vball	vball
vball2pj	vball2pj
vblokbrk	vblokbrk
vbowl	vbowl
vbowlj	vbowlj
vcircle	vcircle
vcombat	vcombat
vcop	vcop
vcop2	vcop2
vegasfst	vegasfst
vegasfte	vegasfte
vegasslw	vegasslw
vendet2p	vendet2p
vendetao	vendetao
vendetas	vendetas
vendetta	vendetta
vendettj	vendettj
vendtaso	vendtaso
venture	venture
venture2	venture2
venture4	venture4
venus	venus
vf	vf
vf2	vf2
vf2a	vf2a
vf2b	vf2b
vf2o	vf2o
vf3	vf3
vf3a	vf3a
vf3tb	vf3tb
vfive	vfive
vfkids	vfkids
vformula	vformula
vfremix	vfremix
vgoalsca	vgoalsca
vgoalsoc	vgoalsoc
vgpoker	vgpoker
vhunt2	vhunt2
vhunt2r1	vhunt2r1
vhuntj	vhuntj
vhuntjr1	vhuntjr1
vhuntjr2	vhuntjr2
victlapw	victlapw
victnine	victnine
victor21	victor21
victor5	victor5
victorba	victorba
victory	victory
victroad	victroad
videomat	videomat
videopin	videopin
vidvince	vidvince
viewpoin	viewpoin
vigilant	vigilant
vigilntj	vigilntj
vigilntu	vigilntu
vimana	vimana
vimana1	vimana1
vimanan	vimanan
vindc2r1	vindc2r1
vindc2r2	vindc2r2
vindctr2	vindctr2
vindice3	vindice3
vindice4	vindice4
vindict1	vindict1
vindict2	vindict2
vindict4	vindict4
vindicte	vindicte
vindictg	vindictg
vindictr	vindictr
viofight	viofight
viofighu	viofighu
viostorm	viostorm
viostrma	viostrma
viostrmj	viostrmj
viostrmu	viostrmu
vipclub	vipclub
viper	viper
viprp1	viprp1
viprp1hk	viprp1hk
viprp1j	viprp1j
viprp1o	viprp1o
viprp1ot	viprp1ot
viprp1s	viprp1s
virnba	virnba
vitaminc	vitaminc
vivdolls	vivdolls
vliner	vliner
vlinero	vlinero
vmahjong	vmahjong
vmetal	vmetal
vmetaln	vmetaln
volfied	volfied
volfiedj	volfiedj
volfiedu	volfiedu
von2	von2
von254g	von254g
vpool	vpool
vr	vr
vroulet	vroulet
vs10yard	vs10yard
vs10yarj	vs10yarj
vs2	vs2
vs215	vs215
vs298	vs298
vs29815	vs29815
vs299	vs299
vs2_2k	vs2_2k
vs2v991	vs2v991
vsav	vsav
vsav2	vsav2
vsava	vsava
vsavh	vsavh
vsavj	vsavj
vsavu	vsavu
vsbbalja	vsbbalja
vsbbaljb	vsbbaljb
vsbball	vsbball
vsbballj	vsbballj
vsfdf	vsfdf
vsgongf	vsgongf
vsgradus	vsgradus
vsgshoe	vsgshoe
vshoot	vshoot
vsmahjng	vsmahjng
vsnetsca	vsnetsca
vsnetscj	vsnetscj
vsnetscr	vsnetscr
vsnetscu	vsnetscu
vsnetseb	vsnetseb
vspinbal	vspinbal
vspinblj	vspinblj
vsskykid	vsskykid
vsslalom	vsslalom
vssoccer	vssoccer
vstennij	vstennij
vstennis	vstennis
vstetris	vstetris
vstriker	vstriker
vstrikro	vstrikro
vtennis	vtennis
vulcan	vulcan
vulgus	vulgus
vulgus2	vulgus2
vulgusj	vulgusj
wacko	wacko
wakuwak7	wakuwak7
wallc	wallc
wallca	wallca
wallst	wallst
wanted	wanted
wardner	wardner
wardnerj	wardnerj
warfa	warfa
wargods	wargods
warlords	warlords
warofbug	warofbug
warpwar2	warpwar2
warpwarp	warpwarp
warpwarr	warpwarr
warrior	warrior
warriorb	warriorb
warzard	warzard
waterski	waterski
watrball	watrball
waverunr	waverunr
wb3	wb3
wb31	wb31
wb32	wb32
wb33	wb33
wb34	wb34
wb35	wb35
wb3bbl	wb3bbl
wbbc97	wbbc97
wbdeluxe	wbdeluxe
wbeachv2	wbeachv2
wbeachvl	wbeachvl
wbml	wbml
wbmlb	wbmlb
wbmlbg	wbmlbg
wbmljb	wbmljb
wbmljo	wbmljo
wboy	wboy
wboy2	wboy2
wboy2u	wboy2u
wboy3	wboy3
wboy4	wboy4
wboyo	wboyo
wboysys2	wboysys2
wboyu	wboyu
wc90	wc90
wc90a	wc90a
wc90b	wc90b
wc90t	wc90t
wcatcher	wcatcher
wcbowl	wcbowl
wcbowldx	wcbowldx
wcbwl12	wcbwl12
wcbwl13	wcbwl13
wcbwl140	wcbwl140
wcbwl15	wcbwl15
wcbwl16	wcbwl16
wcbwl161	wcbwl161
wcbwl165	wcbwl165
wcombaj	wcombaj
wcombak	wcombak
wcombat	wcombat
wcvol95	wcvol95
wecleman	wecleman
weddingr	weddingr
welltrij	welltrij
welltris	welltris
weststry	weststry
wexpresb	wexpresb
wexpresc	wexpresc
wexpress	wexpress
wfortuna	wfortuna
wfortune	wfortune
wg3dh	wg3dh
wgp	wgp
wgp2	wgp2
wgpj	wgpj
wgpjoy	wgpjoy
wgpjoya	wgpjoya
wh1	wh1
wh1h	wh1h
wh1ha	wh1ha
wh2	wh2
wh2j	wh2j
wh2jh	wh2jh
wheelfir	wheelfir
wheelrun	wheelrun
whizz	whizz
whodunit	whodunit
whoopee	whoopee
whp	whp
wiggie	wiggie
wildfang	wildfang
wildplt	wildplt
willow	willow
willowj	willowj
willowje	willowje
wilytowr	wilytowr
windheat	windheat
windheau	windheau
wingwar	wingwar
wingwara	wingwara
wink	wink
winka	winka
winrun	winrun
winrun91	winrun91
winspike	winspike
winspikj	winspikj
wintbob	wintbob
winterht	winterht
wiping	wiping
wiseguy	wiseguy
witch	witch
wits	wits
wiz	wiz
wizard	wizard
wizdfire	wizdfire
wizt	wizt
wizta	wizta
wizwarz	wizwarz
wizzquiz	wizzquiz
wizzquza	wizzquza
wjammers	wjammers
wldarrow	wldarrow
wldcourt	wldcourt
wlstar	wlstar
wmatch	wmatch
wndrmomo	wndrmomo
wndrplnt	wndrplnt
wof	wof
wofa	wofa
wofhfh	wofhfh
wofj	wofj
wofu	wofu
wolfpack	wolfpack
wonder3	wonder3
wondl96	wondl96
wondstck	wondstck
woodpek	woodpek
woodpeka	woodpeka
worldwar	worldwar
wotw	wotw
wotwc	wotwc
wow	wow
wpksoc	wpksoc
wpksocv2	wpksocv2
wrally	wrally
wrally2	wrally2
wrallya	wrallya
wrallyb	wrallyb
wrecking	wrecking
wrestwa1	wrestwa1
wrestwa2	wrestwa2
wrestwar	wrestwar
wrofaero	wrofaero
ws	ws
ws89	ws89
ws90	ws90
wschamp	wschamp
wschampa	wschampa
wseries	wseries
wsf	wsf
wsjr	wsjr
wsjr15	wsjr15
wtennis	wtennis
ww3	ww3
wwallyj	wwallyj
wwallyja	wwallyja
wwester1	wwester1
wwestern	wwestern
wwfmania	wwfmania
wwfmanib	wwfmanib
wwfsstaa	wwfsstaa
wwfsstaj	wwfsstaj
wwfsstar	wwfsstar
wwfsstau	wwfsstau
wwfwfest	wwfwfest
wwfwfsta	wwfwfsta
wwfwfstb	wwfwfstb
wwfwfstj	wwfwfstj
wwjgtin	wwjgtin
wyvernwg	wyvernwg
xday2	xday2
xenophob	xenophob
xevi3dg	xevi3dg
xevios	xevios
xevious	xevious
xeviousa	xeviousa
xeviousb	xeviousb
xeviousc	xeviousc
xexex	xexex
xexexa	xexexa
xexexj	xexexj
xfiles	xfiles
xmcota	xmcota
xmcotaa	xmcotaa
xmcotah	xmcotah
xmcotaj	xmcotaj
xmcotaj1	xmcotaj1
xmcotaj2	xmcotaj2
xmcotajr	xmcotajr
xmcotau	xmcotau
xmen	xmen
xmen2p	xmen2p
xmen2pj	xmen2pj
xmen6p	xmen6p
xmen6pu	xmen6pu
xmenj	xmenj
xmultipl	xmultipl
xmvsf	xmvsf
xmvsfa	xmvsfa
xmvsfar1	xmvsfar1
xmvsfb	xmvsfb
xmvsfh	xmvsfh
xmvsfj	xmvsfj
xmvsfjr1	xmvsfjr1
xmvsfjr2	xmvsfjr2
xmvsfr1	xmvsfr1
xmvsfu	xmvsfu
xmvsfur1	xmvsfur1
xorworld	xorworld
xsleena	xsleena
xsleenab	xsleenab
xtheball	xtheball
xtrial	xtrial
xxmissio	xxmissio
xybots	xybots
xybots0	xybots0
xybots1	xybots1
xybotsf	xybotsf
xybotsg	xybotsg
xymg	xymg
xyonix	xyonix
yachtmn	yachtmn
yamagchi	yamagchi
yamato	yamato
yamato2	yamato2
yamyam	yamyam
yanchamr	yanchamr
yankeedo	yankeedo
yarunara	yarunara
yellowcb	yellowcb
yesnoj	yesnoj
yiear	yiear
yiear2	yiear2
yokaidko	yokaidko
yosakdoa	yosakdoa
yosakdon	yosakdon
yosimoto	yosimoto
youjyudn	youjyudn
youkaidk	youkaidk
youma	youma
youmab	youmab
youmab2	youmab2
yujan	yujan
yuka	yuka
yukon	yukon
yukon1	yukon1
yumefuda	yumefuda
yuyugogo	yuyugogo
zaryavos	zaryavos
zarzon	zarzon
zaviga	zaviga
zavigaj	zavigaj
zaxxon	zaxxon
zaxxon2	zaxxon2
zaxxonb	zaxxonb
zedblade	zedblade
zektor	zektor
zero	zero
zero2	zero2
zerogun	zerogun
zeroguna	zeroguna
zerogunj	zerogunj
zerohour	zerohour
zeropnt	zeropnt
zeropnt2	zeropnt2
zeropnta	zeropnta
zeroteaa	zeroteaa
zeroteab	zeroteab
zeroteam	zeroteam
zerotime	zerotime
zerotrgt	zerotrgt
zerotsel	zerotsel
zerowing	zerowing
zerowng2	zerowng2
zerozone	zerozone
zigzag	zigzag
zigzag2	zigzag2
zingzip	zingzip
zintrckb	zintrckb
zipzap	zipzap
znpwfv	znpwfv
zoar	zoar
zodiack	zodiack
zombraid	zombraid
zombrvn	zombrvn
zookeep	zookeep
zookeep2	zookeep2
zookeep3	zookeep3
zoom909	zoom909
zortonbr	zortonbr
zunkyou	zunkyou
zupapa	zupapa
zwackery	zwackery
zzyzzyx2	zzyzzyx2
zzyzzyxx	zzyzzyxx
